broadcast-range|x-vs|limited-vs|hand-clicker|foot-vs|hand-clicker|loaner-model|model-s|pretty-nice|nice-broadcast|broadcast-range|range-similar|hand-clicker|gate-open|open-outward|perilously-close|mean-come|broadcasting-watt|actually-try|save-power
random-hard|hard-reset|bluetooth-pairing|honda-remember|freshly-add
amg-c43|c43-107k|107k-mile|mechanic-instal|new-starter|starter-motor|starter-motor|motor-require|require-grease|new-mechanic|pretty-good
108k-mile|coolant-leak|water-pump|local-saab|saab-specialty|specialty-shop|new-pump|junkyard-car|similar-issue|good-place
morning-hear|high-pitch|pitch-whine|whine-come|engine-look|55-mph|revs-drive|look-like
tire-pretty|pretty-easily|alignment-issue|lousy-austin|austin-road|difficult-_emoji_|rubber-mallet|grease-suffice
road-trip|long-uphill|uphill-mountain|mountain-drive|good-feedback|volt-preform|preform-spectacularly|west-phoenix|mileage-number|adaptive-cruise|cruise-set|engage-mountain|mountain-mode|battery-leave|speed-limit|limit-hit|shift-gear|optimum-power|old-v8|v8-jeep|violently-downshift|maintain-speed|keep-climb|steady-smooth|smooth-rate|cruise-keep|proper-speed|section-feel|feel-like|like-drive|bit-nervous|mountain-grade|previous-post
end-sit|inch-close|model-come|come-stock|stock-like|previous-owner|lower-spring
daily-driver|long-distance|distance-camping|camping-vehicle|trailer-hitch|hitch-instal|rear-suspension|low-like|look-like|buy-improve|improve-shock|shock-strut|daily-driving
wife-drive|santa-fe|oil-change|oil-change|change-interval|5000-km|synthetic-oil|+-km|km-pass|oil-change|change-interval|change-asap|engine-flush|oil-change|read-online|recommend-engine|engine-flush|flush-esp|modern-car|car-like
getting-jerk|high-quote|sel-like|17kish-otd|mind-tell|otd-price
state-inspection|place-state|upper-low|low-ball|ball-joint|rejection-sticker|ball-joint|sway-bar|bar-issue|ball-joint|pass-inspection
completely-new|pretty-limited|exhaust-system|good-rumble|upgrade-air|air-intake
road-king|rubber-connect|connect-point|feel-like|actually-lock|springy-metal|metal-wire|wire-thing|thing-actually|actually-end|paint-near|rubber-attach|attach-point|annoying-springy|springy-metal|metal-wire
past-experience|simple-fix|issue-ac|ac-cold|cold-air|cold-air|air-stop|stop-blow|cold-air|air-completely|completely-stop|stop-blow|pure-hot|hot-air|try-new|new-freon|ac-heater|heater-air|engine-heat|tell-ac|ac-compressor|compressor-need|need-replace|ac-control|control-unit|unit-break|plastic-knob|knob-break|hot-air|air-gets|gets-blow|pretty-broke|spend-extra|extra-money|replace-repaired|question->|try-freon|completely-sure|>-obviously|new-ac|ac-control|control-unit|generally-cost|long-time|knowledge-advice|greatly-appreciate|wonderful-day
fantastic-sub|sub-today|today-thing|happen-exactly|year-ago|ago-today|ford-come|brilliant-new|new-way|cut-sale|sale-cost|sell-vehicle|repair-garage|immediately-bring|electric-vehicle|repair-shop|sell-vehicle|honest-question
sportster-iron|scream-eagle|kit-scream|scream-eagle|eagle-intake|intake-vance|hines-exhaust|exhaust-17|17-k|k-mile|ve-want|fucking-haul|run-great|highway-speed|run-great|normal-right|m-pretty|pretty-shure|smooth-running|running-engine|engine-right
hi-folk|engine-repair|weird-ticking|ticking-happen|periodically-stall|overly-smart|patiently-wait|important-issue|dealership-today|small-town|people-approx|appear-like|model-car|exact-problem|massive-recall|keep-tell|avoid-drive|bit-worried|main-issue|massive-problem|month-ago|massive-problem|similar-gripe|appear-like|canada-wide|wide-thing|corporate-level|obviously-mirror|old-model|model-imo|report-online|entire-hyundai|hyundai-experience
audi-q5|70k-mile|airbag-replace|receive-notice|takata-airbag|faulty-airbag|humid-condition
currently-look|trd-pro|pro-w/27k|w/27k-mile|fully-aware|great-price|terrible-decision|w/o-taxis
apple-carplay|carplay-apline|apline-radio|install-radio|long-time|find-online|wiring-harness|dash-stock|stock-radio|great-thank
honda-civic|remotely-start|headlight-flash|immediately-visible|grocery-store|successfully-start|viper-system|flash-green|positive-jingle|flash-red|caution-sound|oem-fob|indicator-like
canadian-dealer|different-finish|satin-black|black-finish|finish-17x9|17x9--12|-12-mm|mm-offset|6x5.5-bolt|bolt-pattern|greatly-appreciate|appreciate-thank
svt-cobra|cobra-come|big-fan|old-cobra|special-place|heart-lol|high-school|cobra-model|return-later|later-down
electric-vehicle|good-stealthy|stealthy-charge|charge-station|tesla-wall|wall-charger|craftsman-house|experience-build
test-drive|week-model|model-x|x-p100d|p100d-today|test-drive|owner-advisor|walk-away|activate-summon|come-straight|garage-door|door-opening|car-keep|opening-pretty|pretty-hard|huge-sigh|poor-model|model-x.|problem-like
dodge-dakota|liter-v8|v8-magnum|magnum-quad|quad-cab|size-bed|4x4-light|transfer-case|vin-number|number-run|transfer-case|4lo-indicator
independent-inspection|train-down|38k-mile|mile-luxury|luxury-trim|soft-suspension|m-sport|great-price|pro-nav|nav-heated|heated-seat|e60-530i|usual-check|wear-component|rac-inspection|deleted-badge|badge-luxury|luxury-trim|twin-exhaust
screamin-eagle|eagle-slip|s&s-air|air-cleaner|previous-owner|owner-look|look-online|pretty-sure|s&s-super|super-e|e-setup|order-v&h|v&h-short|short-shot|exhaust-play|different-air|air-cleaner|mechanical-background|carburet-setup
currently-right|cosmetic-mod|mod-jeep|toy-drive|drive-maybe|june-6th|m-getting|getting-lift|tire-size|housing-situation|situation-change|trouble-witha|witha-common|common-parking|parking-garage|lift-pay|real-question|question-come|come-down|run-37|jeep-height|fit-regardless
previous-post|coil-lift|stock-equipment|equipment-bumper|winch-etc|stock-equipment|-door-jk|budget-boost|boost-instead
finally-pop|diff-cover|stock-open|limited-slip|pretty-rough|rough-shape|long-arm|arm-kit|kit-sit|fucker-snap|worth-throw|super-d35|spline-kit
v8-swap|find-kit|strong-internal|add-power
pretty-good|good-idea|currently-drive|apr-stage|gti-dsg|drive-stick|car-payment|civic-si|si-coupe|br-z|suspension-mod|force-induction|obviously-rwd
31-m|month-ago|change-lane|leg-severely|severely-bruise|foot-completely|completely-crush|insurance-company|medical-bill|issue-come|rib-leg|leg-foot|foot-hand|insurance-company|ride-safe|right-equipment|ride-boot|leather-boot
s3-27k|27k-mile|good-price|-30k-mile|tune-switch|130k-carmax|carmax-warranty|bad-idea
x-pipe|honestly-think|h-pipe|muscle-car|kinda-like|x-pipe|pipe-sound|feel-like|muscle-car|feel-right|muscle-car|stock-h|h-pipe|deep-sound|violent-sound|nice-classic|classic-muscle|muscle-sound
year-ago|a5-s|s-line|line-manual|60k-mile|credit-card|card-debt|decent-job|car-inspect|fast-forward|ve-replace|motor-mount|driver-window|window-regulator|fail-clutch|clutch-switch|cruise-control|washer-fluid|blower-motor|motor-work|differential-mount|upside-oil|oil-consumption|good-clutch|great-shape|japanese-car|m-sit|time-bomb|audi-owner
x-continue|new-feature|air-vent|vent-like|new-vent|lot-quieter|big-cross|cross-section|vent-hole|guy-think
hey-guy|model-s.|test-drive|obviously-want|auto-lane|lane-change|mom-tend
mk4-jetta|.8-t|brother-buy|originally-plan|mk7-gti|good-choice|choice-right|big-down|down-payment|poor-formatting|mk6-gti|gti-manual|mk6-gli|gli-manual|manual-preferably|hot-hatch|hatch-fever|mk7-gti|far-superior
clunk-sound|poor-road|suspension-relate|severely-worn|worn-right|right-hand|engine-mount|oil-pan
positive-feedback|additional-question|volt-exclusively|exclusively-outside|south-dakota|volt-handle|handle-snow|snow-ice|keep-track|little-cautious|big-decision
trouble-remove|mount-bolt|brake-line|proper-flush|original-starter|220-k|mechanic-yoga|tool-arm|arm-hand|hand-positioning|diesel-thing|tight-space|good-advice
frequent-reader|actual-average|average-market|market-value|thought-lead|price-guide|market-price|visit-community|community-classfie|classfie-website|price-range|mean-value|excel-number
look-perfect|market-air|air-intake|special-tune|work-perfectly|help-haha|subaru-game
new-rgu|ride-today|nags-head|way-home|flat-tire|geico-insurance|tow-company|friend-hang|ride-home|fortunate-bless|great-group|road-glide|glide-ultra
additional-information|information-honda|honda-accord|year-old|old-36k|year-warranty|ac-engine|engine-etc|etc-.|.-price|look-amazing
usa-market|car-model|somewhat-different|particular-interested|volt-premier
e350-rwd|rwd-sedan|-liter-direct|direct-injection|injection-gasoline|gasoline-v-|lb-ft|ft-torque|e400-rwd|rwd-sedan|-liter-biturbo|biturbo-direct|direct-injection|injection-gasoline|gasoline-v-|lb-ft|ft-torque|california-btw
rear-power|power-shade|c140-coupe|aftermarket-reproduction|reproduction-gear|non-mb|mb-gear|terrible-quality|w210-w140|c-class
pretty-straight|straight-forward|forward-look|slip-ons|ons-bomber|bomber-slash|slash-cut|header-powerflex|powerflex-header|catalytic-converter|deep-rumble|v&h-setup|big-sucker|fp3-tune|format-issue
flywheel-conversion|tdi-dmf|dmf-bail|bail-hard|sachs-kit|kit-_url_|safe-bet
finally-build|tesla-store|new-store|product-specialist|absolute-dream|dream-job|tesla-rank|guy-enjoy|sell-come|kpi-job|people-force|people-end|general-experience|tesla-sorry|experience-soon
bfg-ko2s|ko2s-recently|northridge-4x4|tire-size|find-online|feel-free|ask-question
mustang-gt|alternator-gauge|gauge-dancing|dancing-esp|bad-voltage|voltage-regulator|test-drive|new-test|test-fine|week-later|later-sit|alt-gauge|gauge-start|start-dance|car-die|die-like|gas.so-eather|fuel-gauge|read-wrong|fuel-pump|has.any-idea
seriously-doubt|high-mileage|mileage-cpo|like-interesting|interesting-timing|low-cost|cost-model|model-s|s-cpos|depreciate-significantly|good-buy|buy-right|previously-sell|sell-use|use-car|high-mileage|mileage-right|aggressively-cut|low-mileage|mileage-pre|pre-owned|totally-new|new-category|extra-revenue|major-pivot|extra-service|increase-fleet|model-3s|refurbish-work|good-way|increase-workforce|assume-sale|actually-sure|help-boost|quarter-end|delivery-target|new-car|increase-revenue|smooth-ramp|scale-production|help-alleviate|spend-~$35k|fast-way|boost-revenue|forward-regardless|production-ramp|primary-motivation|premium-car|p100d-loaner|high-end|end-car|model-s|s-owner|buy-new|new-car|large-influx|old-model|model-s|new-model|high-mileage|mileage-car|time-come|high-mileage|mileage-cpo|cpo-program|program-like
decent-cheap|cheap-car|post--honda|low-price|major-expensive|expensive-repair|repair-like|like-engine|engine-replacement|30-km|summer-think|200-km|800-km|round-trip|look-good|carfax-report
happy-saturday|saturday-boy|leave-car|car-wash|epc-light|light-come|turn-engine|car-recently|semi-major|major-repair|drive-like
currently-think|ecoboost-mustang|video-online|sound-pretty|pretty-good
1st-toyota|recently-offer|good-deal|keep-look
50-lb|lb-german|german-shepherd|shepherd-puppy|100lbs-easily|sporty-car|new-mustang|mustang-gts|pretty-big|probably-grow
quick-question|relatively-new|4wd-vehicle|97runner-light|late-summer|engage-4wd|fact-engaging
long-print|night-print|start-print|actual-project|finally-able|heating-element|melt-filament|filament-underneath|tape-fiberglass|fiberglass-wrap|cable-tube|un-fixable
hey-guy|super-sweet|speed-sit|mom-neglect|major-issue|basically-disintegrate|start-restore|main-question|acura-rsx|rsx-type|axle-need|need-replace|tie-rod|ball-joint|previous-owner|owner-tell|tl;dr-try|4x4-run
proud-owner|mint-condition|relatively-minor|maybe-useful|useful-upgrade|face-lift|lift-version|considerably-large|car-mirror|minor-touch|know-bumper|bumper-headlamp|headlamp-rear|rear-light|light-cluster|new-wide|wide-space|space-boot|boot-lid|lid-volvo|volvo-logo|easy-cheap
toyota-4runner|sr5-v6|v6-2wd|2wd-automatic|3rd-car|automatic-vehicle|niggle-like|idle-speed|constant-adjustment|adjustment-bad|bad-mpg|mpg-slow|slow-acceleration|average-leg|leg-room|2nd-row|motorize-antenna|antenna-mechanism|need-replace|plastic-tooth|thing-lol|definite-positive|great-styling|styling-inside|2nd-gen|gen-look|look-great|great-build|build-quality|interior-surprisingly|surprisingly-good|road-capability|2wd-especially|smooth-v6|fantastic-stock|stock-exhaust|exhaust-note|note-good|good-visibility|electric-slide|slide-tailgate|tailgate-window|window-comfortable|comfortable-seat|rear-cargo|cargo-area|area-trade|mediocre-2nd|2nd-row|row-legroom|excellent-ride|ride-thank|great-stock|stock-suspension|suspension-tuning|stupid-good|good-resale|resale-value|somewhat-forget|forget-toyota|toyota-4runner|2nd-gen|gen-4runner
merry-christmas|christmas-porsche|porsche-fan|begin-look|40k-budget|budget-maybe|maybe-slightly|cayman-s|perfectly-fine|price-range|early-model|pdk-start|narrow-down|exact-model|likely-look|new-model
rear-passenger|passenger-window|window-recently|recently-drop|cold-day|little-repair|repair-kit|repair-video|regulator-remove|rear-window|window-regulator|broken-plastic|plastic-piece|avoid-buy|rivet-gun|likely-rarely|rarely-use
jeep-cherokee|cherokee-sport|sport-feel|feel-like|pothole-away|micheal-bay|bay-style|style-explosion|high-school|160k-mile|pure-breed|breed-prone|prone-issue|crack-cylinder|cylinder-head|head-thank|friendship-end|shall-begin|vehicle-relatively|relatively-soon|mechanic-ability|big-job|haul-power|small-boat|boat-trailer|truck-include|mid-small|small-size|size-range|-cylinder-4wd|4wd-obviously|obviously-reliability|reliability-probably|readily-available|greatly-appreciate|appreciate-thank
hey-guy|guy-sadly|trouble-decide|mazda3-base|base-model|model-manual|mazda3-sport|sport-model|model-automatic|big-issue|cruise-control|cost-~$|new-car|cruise-control
wrx-wagon|11k-original|original-mile|guy-read|down-close|rebuilt-title|spend-money|money-purchase|catback-accessport|accessport-airfilter|airfilter-possible|possible-bov
month-ago|passat-r|r-line|local-dealer|great-deal|month-lease|new-job|new-a3|sound-dismissive|personal-finance|finance-help|vwag-allow
jeep-guy|long-time|big-priority|4th-gen|-120k-mile|5th-gen|-100k-mile|financial-situation|12k-upfront|5th-gen|body-style|style-necessarily|3rd-party|party-advice|long-post
hey-guy|bowden-tube|jam-today|metal-connector|tube-break|3d-printable|metal-connector|connector-piece|extruder-motor
hey-guy|3d-printer|pretty-big|big-jam|brass-piece|piece-connect|bowden-tube|filament-jam|brass-piece|try-heat|filament-down
hello-/lexus|little-bit|know-2007s|ring-issue|2nd-gen|new-2is|engine-issue|perfectly-fine|snow-tire|is250-rwd|carbon-engine|engine-issue
hey-guy|time-poster|long-time|time-reader|pre-approve|car-purchase|sub-family|forester-xt
turbo-coupe|high-mileage|turbos-70k+|clean-example|50k-mile|mid-$60k-range|end-depreciation|anticipate-appreciation|appreciation-down
model-x|x-owner|owner-notice|large-discrepency|battery-state|available-mile|drive-vs|vs-actual|actual-drive|drive-mile|battery-life|s.-thank
no-no|steel-spring|e200d-exclusive|exclusive-luxury|20-multispoke|s-class|ride-completely|completely-ruin|want-amg|amg-rim|luxury-look|air-suspension|4k-option|option-nearly
total-misuse|uk-selling|new-w204|w204-wheel|look-incredibly|incredibly-tired|fresh-look
month-ago|look-online|long-story|story-short|local-junkyard|junkyard-buy|work-good|amp1-break|long-life|life-span
drive-past|owner-today|good-wave|subreddit-bud|poop-day|obligatory-picture|bad-quality|old-ipod
school-resource|resource-vehicle|local-school|school-officer
hi-guy|m-contemplate|model-s|m-notice|look-like|like-christmas|christmas-light|look-online
jeep-wrangl|wrangl-sahara|unlock-map|map-error|sirius-sub|update-firmware|dealer-website|website-ask|sd-card|navi-package
227-k|k-mile|mile-like|3rd-gear|gear-shift|shift-down|4th-overdrive|certain-throttle|throttle-position|drain-fill|fill-method|year-ago|light-throttle|throttle-input|high-throttle|throttle-position|certain-speed|late-aside|awd-model|nbsp-fwiw|transmission-fully|fully-rebuild|60-k|k-mile|mile-ago|transmission-intercooler|interesting-consider|tow-hitch|hitch-instal|maybe-transmission|transmission-cooler|exactly-tell|transmission-fluid|fluid-flush|nbsp-question|solenoid-responsible|transmission-pathway|bad-electrical|electrical-connection|transmission-problem|tranny-engine|engine-vehicle|vehicle-combo|tranny-pan|car-regularly|great-option|work-ft|exactly-try|repair-shop|nbsp-thank
potentially-interested|chevy-volt|bit-shocking|volt-dropping|dropping-like|model-change|non-econocar|econocar-depreciate
new-subaru|subaru-right|like-new|new-car|distinct-difference|impreza-hatchback|certain-situation|miss-thing|-door-low|low-price|-door-start|fuel-economy|particular-highway|highway-mileage|interior-material|personal-preference|nicer-drive|drive-experience|manual-transmission|crosstrek-increased|increased-ride|ride-height|contribute-mainly|road-capability|like-sit|sit-higher|plastic-body|body-cladding|interior-material|personal-preference|crosstrek-use|road-capability|include-x|x-mode|optimize-torque|torque-distribution|low-speed|speed-traction|hill-descent|descent-control|similar-stuff|manual-transmission|big-deal|-speed-manual|manual-like|extra-gear|impreza-shifter|official-tow|tow-rating|tow-rate|unrelated-reason|torque-y|huge-bonus|bonus-point|edit-add|add-tow|crosstrek-list
time-subaru|subaru-owner|recently-purchase|b4-gt(ej20|gt(ej20-4at|sound-like|shift-high|relatively-low|drop-rpm|vacuum-line|intake-sensor|similar-issue
new-headlight|headlight-assembly|eagle-eye|capa-certify|look-stellar|pay-like|drive-home|gently-spread|jagged-line|line-like|like-8|8-ft|look-normal|shame-dollar|start-knock|knock-stuff|lawsuit-kidding
m-try|different-apartment|place-tell|wall-socket|cost-money|extension-cord|permanent-fixture|fixture-plug|upto-code|current-place|explain-time|ul-list|portable-device|surely-gm|violate-fire|fire-code|code-right|good-way|keep-approach|m-sad
hey-guy|guy-know|web-development|ben-sullins|model-s|s-version|ice-car|p.s.-sorry
past-friday|oil-change|gen-hb|old-oil|jiffy-lube|lube-conventional|conventional-synthetic|synthetic-blend|cheap-option|straight-conventional|conventional-oil|straight-conventional|conventional-oil|synthetic-conventional|conventional-blend|conventional-oil
fellow-saabers|cool-fan|car-overheat|overheat-recently|hot-weather|radiator-fan|fan-resistor|engine-bay|notice-maxi|maxi-fuse|upside-down|down-like|like-metal|metal-portion|portion-point|sound-insane|car-check|fuse-location|fan-run|week-ago|epic-practical|practical-joke|possible-thing|hg-replace|zero-sense|seriously-confused
wrangl-se|start-drive|bit-san|san-diego|diego-county|county-represent|realize-recovery|recovery-point|good-place|detail-like|diy-install|install-price|price-vs|vs-quality|quality-etc|etc-.|relatively-paranoid|wheel-solo
previously-shop|long-term
little-backstory|daily-basis|central-nj|look-like|subie-guy|new-wrx|subie-culture|highly-doubt|+-wrx|probably-wave|let-hear|guy-drive
big-car|car-guy|year-later|km-definitely|definitely-low|forseeable-issue
console-insert|street-glide|crack-n|n-fade|shop-thst|find-someplace|someplace-capable
local-work|saab-card|32-mb|mb-card
subie-fam|little-help|sway-bar|bar-spring|possibly-lift|good-route|nice-ride|rally-ready|rally-drive|good-place|guy-know|good-deal
market-leave|down-engine|try-search|honest-opinion|worth-consider|consider-thank
center-console|console-box|damn-small|large-circle|circle-shape|shape-mechanism|loose-end|shit-xd
correct-place|current-car|new-mercedes|good-deal|deal-down|small-detail|guy-come|new-s500e|main-perk|price-difference|new-s550e|happen-right|throw-money
wiring-diagram|vent-seat|seat-switch|switch-_url_|enyone-point|right-direction|main-question|heating-seat|seat-switch|switch-_url_|vents?(heating-switch|alot-cheap
hard-bag|hold-shut|bungee-cord
impreza-rs2.5|rs2.5-manual|manual-tran|shake-happen|parking-space|sharp-corner|car-shake|shake-loudly|sound-like|car-underneath|hear-people|torque-bind|new-viscous|viscous-coupling
fp3-instal|extension-cable|battery-compartment
.0-t|t-rhd|rhd-model|model-different|different-reservoir|try-turn|push-down|somewhat-concern|probably-break
jeep-probably|year-ago|new-jeep|home-mortgage|8k-down|down-payment|exciting-like|like-vacation|hard-time|time-justify|justify-buy|course-speak|income-class|good-run|run-jku
guy-glad|oil-change|8k-mile|tranny-fluid|look-like|pretty-dark|slight-gassy|gassy-smell|general-service|moment-right|tranny-fluid|replace-immediately|deliver-package|hour-shift|travel-maybe|hour-shift|shift-today|dealer-tomorrow|thank-mike
hellow-fellow|fellow-lexus|lexus-driver|small-green|green-light|fm-transmitter|cig-light|light-thing|green-light|light-turn
new-type|type-r|look-deadly|great-look|look-car|new-touring|buy-early|speed-junky|type-r|r-look|look-pretty|pretty-badass|sowould-love|ve-hear|turbos(type-r|r-wrx|s-true|bro-mom|low-40
capital-intensive|intensive-process|begin-work|add-fuel|short-position|car-company|electric-vehicle|generate-lithium|lithium-ion|ion-cell|tesla-plan|tesla-position|cell-supplier|future-market|ev-battery|start-build|build-power|power-train|train-component|car-company|apple-buying|buying-display
current-thread|knowledge-advice|mechanical-knowledge|old-day|engine-building|gto-grand|grand-national|national-chevelle|japanese-tuning|tuning-scene|project-car|1jz-swap|mk3-supra|local-car|car-coffee|1jz-swap|swap-mk3|ungodly-exhaust|exhaust-sound|sound-single|single-turbo|turbo-470whp|recommend-stick|comb-club|club-lexus|lexus-supra|supra-forum|know-forum|recent-thread|organize-thing|-400hp-range|pretty-detailed|detailed-guide|clean-look|look-single|single-owner|owner-sc300|sc300-auto|110k-mile|mile-near|solid-plan|maybe-consider|consider-sell|engine-tran|supposedly-decent|decent-condition|car-manual|main-concern|concern-right|wiring-harness|advice-suggestion|decent-background|thought-process|advice-suggestion|suggestion-comment|comment-concern|project-like
volt-lt|kinetic-blue|typically-travel|gas-engine
volt-owner|buy-gas|fall-completely|co-host|podcast-relate|tony-posawatz|historical-detail|future-straight|volt-development
long-verify|verify-carfax|carfax-history|new-tire|tire-oil|oil-change|change-valve|valve-cover|cover-gasket|gasket-time|time-belt|water-pump|pump-cam|cam-seal|seal-spark|spark-plug|plug-k&n|k&n-air|air-filter|6speed-manual|lighting-package|package-sport|sport-package|leather-power|power-seat|great-deal|reputable-audi|audi-vw|vw-shop|wanna-consult|expect-close|250k-mile|good-care
ford-focus|focus-titanium|constant-repair|brand-new|new-mind|drive-home|home-mazda|mazda-grand|grand-touring|touring-edition|edition-hatchback|25k-mile|look-forward|no-long|long-deal|constant-transmission|transmission-issue|break-down|new-owner|repair-history|history-aside|normal-stuff|decent-car|car-seat|seat-cover|cover-suggestion|audio-equipment|drive-client|clean-clothing|beige-tan|tan-color|bose-system|door-panel|sound-distribution|small-sub|look-forward|year-hopefully|hopefully-year
old-car|fully-optione|add-oil|smug-test|traction-control|computer-trouble|new-paint|paint-job|heat-cooled|cooled-seat|worth-repair|new-shitty|shitty-car
hi-recently|recently-buy|smooth-quieter|service-soon|soon-light|light-blink|rough-idle|idle-intermittently|ac-system|system-like|fan-turn|slight-vibration|vibration-compare|absolute-quiet|roughness-come|accessory-cycling|fan-.|.-nbsp|head-light|dimmer-intermittently|old-halogen|halogen-car|nbsp-tap|tap-noise|cruise-speed|old-bmw
bad-price|new-york|experience-drive
recently-upgrade|honda-pilot|pilot-ex|ex-headunit|headunit-infotainment|infotainment-screen|honda-pilot|pilot-ex|anti\-theft-radio|radio-code|temporarily-bypass|anti\-theft-radio|radio-code|serial-number|new-headunit|vin-associate|anti\-theft-code
currently-drive|f150-lariat|fairly-consistent|consistent-transmission|transmission-failure|taurus-sho|ask-price|recently-drive|weekend-getaway|mile-round|round-trip|thing-hold|accountant-sister|student-loan|loan-debt|insurance-company|truck-thing|thing-target|target-shooting|shooting-hunting|hunting-fishing|fishing-haul
bmw-guy|panamera-gts|initially-look|low-mileage|karma-red|good-deal|luxury-car|agent-tell|insane-extended|extended-warranty|warranty-option|option-available|.2k-usd|normal-limited|200k-kilometer|sound-entirely|feel-like|extended-coverage|coverage-warranty|coverage-obviously|include-expendable
x3-xdrive28i|xdrive28i-suv|premium-sound|sound-system|mind-boggle|new-vehicle|vehicle-especially|bluetooth-technology|connect-phone|phone-audio|ford-escape|owner-address|usually-mind|auxillary-cord|equally-good|good-sound|sound-quality|play-thing|radio-xm|xm-usb|usb-port|new-phone|google-pixel|auxiliary-port|irritating-issue|like-phone|phone-manufacture|use-bluetooth|different-bluetooth|bluetooth-audio|audio-transmitter|sound-terrible|static-sound|water-non|non-existent|existent-bass|bass-treble|treble-etc|etc-.|remain-connect|center-console|power-outlet|auxiliary-port|port-bluestream|best-buy|sound-ok|sound-incredibly|incredibly-low|low-quality|quality-compare|run-directly|static-type|type-sound|low-bass|bass-treble|quality-volume|significantly-etc|etc-.|equalizer-option|warranty-plus|like-consideration|aftermarket-sterio|sterio-replacement|replacement-option|sound-quality|long-post|post-haha
volvo-folk|125-k|k-mile|109-k|k-mile|mile-onwards|brake-booster|booster-cluster|cluster-reflow|reflow-ignition|ignition-coil|coil-ignition|ignition-lock|lock-new|new-battery|battery-new|new-starter|starter-new|new-timing|timing-belt|belt-water|water-pump|tensioner-new|new-sway|sway-bar|rear-rear|rear-stay|stay-bar|bar-new|new-radiator|c-recharge|wheel-bearing|ball-joint|abs-sensor|sensor-regular|regular-oil|oil-change|conventional-oil|ignition-lock|previous-owner|long-list|heater-score|score-good|recharge-soon|transmission-fluid|fluid-change|introduce-new|new-tranny|tranny-fluid|fluid-slowly|drain-fill|thousand-kms|transmission-problem|pcv-system|good-base|glove-test|issue-arise|visually-inspect|visual-inspection|entail-maybe|glove-test|wheel-spin|slippery-slushy|slushy-day|day--once|stop-position|stop-position|particularly-care|cargo-space|safety-feature|reasonable-price|price-tag|tag-vs|subarus-imo|angle-gear|gear-check
title-state|old-vw|vw-break|break-down|month-ago|college-student|need-awd|price-range|probably-look|guy-suggest|suggest-look|common-problem|100k-mile|price-range|edit-thank
car-recently|radiator-fan|ac-compressor|engine-temperature|temperature-sensor|sensor-think|radiator-fan|year-ago|check-engine|engine-light
hello-reddit|w203-panoramic|panoramic-coupe|previous-owner|shade-work|shade-got|got-stick|stick-open|movement-whatsoever
time-poster|engine-open|initial-diagnosis|throw-rod|spun-bearing|long-story|story-short|gasket-blow|free-way|engine-shut|shut-down|internal-engine|engine-work|sound-like|like-shit|immediately-shut|throw-rod|spun-bearing|shop-close|new-engine
second-time|brake-burn|squeal-non|non-stop|stop-like|special-snowflake|snowflake-x|long-brake|brake-breakin|breakin-period|edit-sorry|sorry-mod|bacon-reader|cell-phone|help-appreciate|home-computer
heated-seat|heated-seat|barely-warm|basic-car|car-like|turn-down|seat-heater
hello-r|r-wrangler|new-sub|r-amateurcarporn|sfw-sub|sub-dedicate|redditor-share|share-pic|pic-video|come-check
proper-picture|bit-dusty|guy-think
flatbed-truck|truck-come|tow-hook|tow-hook|tire-inflator|volt-premier
mp-mini|small-square|square-like|like-130|130-mm|140-mm|little-room|bed-clip|rectangle-glass|130-mm|mm-160|160-mm|mm-thick
day-ago|exact-process|blue-painter|painter-tape|light-layer|glue-stick|finish-printing|actual-cat|cat-start|usually-bump|printing-speed|actual-filament|filament-touch|stay-stick|filament-platform|little-spot|wrong-type|right-type
hi-guy|new-car|car-i'm|i'm-interested|335i-coupe|coupe-x|x-drive|drive-m|m-package|package-335i|335i-coupe|coupe-x|x-drive|drive-maybe|maybe-m|m-package|package-335i|335i-x|x-drive|drive-m|m-package|m3-coupe|k-canadian|30-k|fun-daily|daily-driver|driver-maybe|guy-think
sound-like|engine-roar|slow-down|barely-hear|electric-range|down-significantly|day-ago|2nd-charge
story-start|start-monday|monday-morning|brand-new|tech-tell|fast-forward|hey-sorry|extra-careful|new-wheel|think-wow|mount-wheel|snow-pretty|pretty-heavy|bad-idea|fast-forward|car-obviously|outside-lip|microfiber-cloth|silver-metal|metal-expose|black-powder|powder-coat|huge-gash|look-like|black-filler|filler-touch|paint-dry|wheel-look|look-perfect|know-wheel|saturday-morning|new-wheel|picture-album|tl;dr-dealer|dealer-scratch|scratch-brand|brand-new|new-wheel
civic-hatchback|hatchback-soon|sale-literature|literature-state|state-premium|premium-fuel|hard-requirement|casual-driver|sport-trim|trim-look
hey-folk|quality-reliability|luxury-suv|sporting-quality
test-drive|fit-ex|vent-blower|past-level|jet-engine|hyundai-accent|accent-saturn|saturn-ls|ls-ford|ford-focus|fit-vent|common-issue
look-like|brake-light|past-couple|state-inspection|week-ago|ago-_emoji_|remember-buy|bright-bulb|different-bulb|look-like|bright-bulb
-door-hatchback|hatchback-veloster|veloster-turbo|turbo-soon|winter-driving|fun-whip|whip-handle|snowy-condition|edmonton-alberta|pretty-deadly|deadly-winter|drive-long|long-highway|work-everyday
reg-cab|cab-xlt|pavement-tell|transfer-case|basically-brand|brand-new
2nd-gen|fully-aware|power-horse|maintain-100|100-km/h|quarter-tank|3rd-gear|new-exhaust|long-tube|tube-header|d-pipe|pretty-pretty|pretty-sure|engine-mod|money-time|electric-fan|battery-intake|intake-swap|currently-run|run-near|near-stock|stock-tire
old-crappy|crappy-laptop|typically-use|support-cura|greatly-appreciate
dedicated-laptop|cheap-budget|budget-laptop|laptop-strictly|slicing-software|main-machine|macbook-pro|mac-version|mac-tutorial|right-away|possibly-share|find-actual|actual-gcode|throw-directly|sd-card
dream-truck|trail-edition|test-drive|dealer-claim|previously-replace|kdss-pump|pump-line|line-etc|etc-.|work-fine|loud-rattle|rattle-loose|loose-feel|end-dash|dash-light|different-dealer|dealer-want|option-wise|wise-reddit|regular-old|old-sway|sway-bar|bar-link|wanna-point|knowledgeable-tech
rust-belt|belt-brand|brand-new|shit-box|occasionally-want|year-max|use-brine|brand-new|new-vehicle|irreparable-damage|time-assume|salt-touch|truck-start|require-continuous|continuous-exposure
fuel-level|level-sensor|sensor-break|break-down|immobiliser-ignition|ignition-change|computer-restart|random-occasion|oil-level|level-rise|need-garage|garage-intervention|intervention-quick|quick-fix|bit-excessive|brand-new|new-car
n54-engine
hi-guy|220d-sport|dpf-remove|sound-nice|avg-fuel|fuel-consumption|consumption-drop|.3l/100-km|big-improvement|tank-avg|avg-everytime
modify-volvos|retrofit-old|old-volvo|volvo-alloy|new-model|model-like|c30-s40|s40-v50|v50-s60|s60-s80|s80-xc70|xc70-v70|v70-model|alloy-wheel|cetus-centaurus|centaurus-columbia|columbia-tellus|volvo-currently|modification-equally|new-alloy|alloy-fit|old-volvo|volvo-e.g.
limited-version|subaru-crosstrek|regret-purchase|road-noise|steering-agility|agility-etc|etc-.
dash-cam|parking-mode|hardwiring-kit|kit-need|accessory-source|help-decide|pretty-sure|center-console|console-outlet|hardly-use|hear-people|people-tap|power-door|fuse-box
wife-order|order-christmas|christmas-ornament|ornament-production|production-run|thermister-bite|thermal-runaway|white-smoke|black-brown|brown-goop|ptfe-tube|yeah-thermister|completely-unusable|glass-bead|bead-break|run-soon|instruction-etc|minimum-hassle|hassle-fast|fast-shipping|bit-price|price-conscious|recently-buy|monoprice-maker|maker-select|select-plus|thing-handle|handle-overhang|overhang-horribly|help-fit|new-hotend|e3d-lite|reprap-replacement|replacement-e3d|e3d-block|sock-replacement|e3d-lite|upper-end|print-nylon|nylon-etc|etc-suggestion
youth-70s/80s|today-trade|common-thing|ride-til|big-bike|surprisingly-fun|reliability-factor
experience-remove|remove-store|trektop-nx|big-concern|good-solution|viable-option
premium-gt|gt-roush|50k-mile|primarily-look|good-price|plan-add
new-f150|throttle-response|fuel-economy|ecoboost-ford|no-sure|throttle-response|throttle-response|response-kinda|kinda-suck|fix-like|tow-haul|haul-mode|mode-help|previous-gen
m-currently|currently-buy|sit-down|colosseum-gray|look-great|google-image|obviously-different|different-colour|major-dealership|pretty-frustrating|different-colour|pretty-angry
collision-warn|warn-false|false-positive|red-obstacle
heated-seat|worth-upgrade|base-stock|stock-system|system-suffice|upgrade-ability|ability-aftermarket|aftermarket-wise|wise-later|thank-guy
bmw-family|year-ago|repair-cost|41k-mile|15k-yr|problem-repair|personal-experience
honda-accord|accord-coupe|coupe-ex|ex-4cyl|4cyl-recently|oil-change|power-steering|steering-fluid|fluid-flush|normally-perform|routine-oil|oil-change|change-brake|brake-tire|tire-transmission|transmission-fluid|fluid-drain|drain-refill|30k-brake|brake-fluid|spark-plug|plug-valve|valve-adjustment|timing-chain|water-pump|preventative-maintenance
i've-read|old-basket|basket-case|run-down|down-junker|colder-month|simply-replace|old-bike|bike-like|new-wrencher|wrencher-look|long-term|term-project|project-bike
_url_-right|right-rear|rear-lca|lca-mount|vs-road|road-debris|road-guy|guy-know|road-shop|drive-fine|rip-metal|start-crack
unknown-reason|sound-come|car-speaker
new-car|x5-35i|35i-getting|getting-rid|4runner-limited|price-difference|hard-time|time-find|find-information|trim-level|wheel-panoramic|panoramic-sunroof|sunroof-surround|surround-camera|camera-nevada|nevada-leather|leather-roof|roof-rail|rail-power|power-tailgate|tailgate-paint|paint-match|match-fender|fender-trim|trim-etc
company-demo|audi-a4|a4-fwd|fwd-premium|premium-plus|.0-t|t-premium|premium-plus|plus-technology|technology-navigation|navigation-bang|bang-olufsen|list-price|company-demo|demo-vehicle|reputable-dealership|attach-sticker
hid-bulb|involve-unclippe|maf-sensor|air-clean|clean-box+snorkel|second-max|warn-light|maf-sensor|sensor-disconnect|headlight-replacement|replacement-reinstall|bulb-work|traction-control|control-light|instrument-cluster|cluster-read|read-check|check-vsc|warning-persist|couple-cycle|car-sit|sit-overnight
87k-mile|engine-number|number-match|balance-shaft|shaft-issue|engine-light|light-come|entire-cabin|cabin-start|start-shake|free-code|code-scan|cryptic-intake|intake-manifold|manifold-code|cylinder-misfire|code-reader|couple-time|cylinder-fix|sound-like|incoming-disaster|little-concerned|horror-story
diy-qi|qi-charger|center-console|wireless-charger|storage-console|console-lid|yesterday-realize|door-hand|hand-pull|regular-iphone|door-panel|model-lexus
project-driver|driver-volvo|fuel-pump|pump-access|access-hatch|hatch-allow|faulty-pump
additional-fuse|fuse-box|factory-wiring|30a-relay|delphi-packard|metri-pack|pack-connector|screw-terminal|money-time|negative-bus|add-external|external-relay|clean-imo
bluetooth-phone|play-music|lexus-toyota|toyota-vehicle|dealer-soon|iphone-bell|work-flawlessly|lgg4-virgin
anzo-headlight|honda-accord|bulb-size|size-high|current-oem|oem-headlight
blue-leather|leather-seat|seat-cover|volt-accessory|volt-owner|specifically-suggestion|seat-cover|love-input
know-traditional|traditional-advice|flood-car|y-o|o-car|car-enthusiast|air-cool|project-car|porsche-start|recently-pass|pass-away|good-way|flood-911s|electronic-motor|motor-tran|rear-end|end-minor|minor-damage|flood-car
hey-r|r-honda|lower-spring|accord-sedan|conflict-information|shock-absorber|oem-absorber|purchase-new|new-lower|lower-spring|50k-mile
entire-life|dream-come|come-true|month-predate|purchase-learn|stereotypical-young|young-bmw|bmw-purchaser|fast-forward|prized-possession|live-learn|live-paycheck|car-justice|upkeep-exactly|lose-time|dream-car|engine-maintenance|strong-suspicion|need-replace|baby-purr|purr-like|check-engine|engine-light|passionate-community
start-blue|month-fix|ignition-pathway|new-ecu|ecu-program|month-away|ecu-configuration|usual-way|tech-ii|brew-city|easily-doable|swedish-automotive|factory-program|southwestern-bc|western-wa|bricked-car|bonus-point|ecu-me9|non-trivial|fellow-saab|saab-enthusiast|tech-ii|ii-experience|ecu-flashing|patience-confidence
.0-t|great-little|little-car|great-price|power-whatsoever|work-turn|turn-signal|signal-seatbelt|seatbelt-alarm|alarm-etc|actual-radio|new-radio|security-thing|thing-issue|start-like|aftermarket-radio|help-possible|aftermarket-radio|.0-t
title-suggest|led-lowbeam|metal-adapter
father-buy|165k-mile|read-online|bad-idea|luxury-car|pay-3k|free-win|win-check|3l-na|na-v6|v6-single|single-overhead|overhead-cam|cam-sohc|sohc-18v|18v-automatic|open-engine|engine-oil|oil-cap|coolant-leak|leak-mix|car-inspect|run-good|weird-smell|inside-look|look-like|got-flood|history-report
sportster-1200c|near-dallas|dallas-tx|clutch-cover|cover-left|left-rear|rear-turn|turn-signal|signal-leave|turn-signal|signal-master|master-cyl|cyl-rebuild|rebuild-kit|kit-caliper|caliper-rebuild|rebuild-kit|kit-battery|battery-cover|cover-forward|forward-control|control-clutch|clutch-lever|lever-clutch|clutch-perch|perch-leave|leave-mirror|engine-mount|mount-bolt|seat-solution|split-seat|low-priority
88k-mile|mechanic-near|head-gasket|time-belt|belt-replacement|103k-mile|pay-blood|blood-suck|suck-moron|different-subaru|subaru-dealership|recommend-pay|extreme-regret|barely-shy|brand-new|year-old|old-vehicle|hit-disappointment
new-s60|continental-mobility|mobility-kit|advanced-version|parking-lot|air-escape|easily-find|puncture-spot|volvo-roadside|roadside-assistance|tow-truck|phone-inform|closed-volvo|volvo-dealership|dealership-leave|reality-volvo|volvo-roadside|roadside-assistance|business-hour|mobility-kit|mobility-kit|fix-sealer|temporary-emergency|emergency-fix|latex-base|tire-place|stuff-clean|tire-repair|stuff-affect|tpms-sensor|tire-plug|plug-kit|mobility-kit|kinda-pricey|tire-sealer|car-volvo|volvo-roadside|roadside-assistance|completely-useless
car-sit|sport-plus|plus-mode|pdk-revs|normal-mode|standard-maintenance|xpel-coating|post-pic|cayman-gts
nail-down|chevy-volt|pretty-small|small-potato|grand-scheme|work-onstar|onstar-module|module-replacement|recall-turn|turn-signal|automatically-turn|fixable-issue|title-information|particular-song|sixteen-character|hilarious-abbreviation|issue-happen|try-refresh|finger-pointing|volt-advisor|issue-specific|finally-basic|basic-googling|technology-operate
sup-peep|peep-want|similar-issue|volvo-s40|randomly-usually|turn-lose|electrical-power|electrical-function|fuel-pressure|pressure-sensor
edit-sorry|sorry-misleading|misleading-title|title-look|look-like|f-mean|mean-is-|ask-specifically|f-sport|sport-awd|entirely-sure|difference-year|prospective-buyer|headlight-etc|etc-etc|etc-.|.-cheer
early-troubleshooting|troubleshooting-thread|standard-operating|operating-voltage|black-red|red-wire|ui-controller|open-printer|printer-case|case-handy|lcd-firmware|firmware-turn|early-problem|shining-moment|multimeter-probe|red-wire|wire-right|current-setting|dead-short|backlit-screen|bed-push|servo-forcibly|forcibly-hold|find-similar|similar-symptom|refresh-lcd|lcd-firmware|firmware-process|limit-switch|switch-button|button-hold|maybe-try|try-refresh|motion-controller|controller-firmware|stupid-mistake|measure-current|meter-set|board-level|level-troubleshooting|troubleshooting-hint|red-black
q3-instead|120-mm|mm-ground|ground-clearance|option-132kw|usd-price|price-difference|stage-ii|ii-apr|stage-ii|285ps-approx|plan-mention|350ps-approx
usually-pump|new-station|station-cuz|cuz-need|need-gas|mention-premium|gucci-bois|sweet-premium|fellow-redditor|new/-different|different-headlight
hey-guy|new-4runner|trim-package|common-upgrade|rear-bumper|bumper-slider|slider-roof|roof-rack|rack-icon|icon-suspension|slight-lift|road-premium|sr5-4wd|trim-package|thank-guy
vw-yesterday|good-deal|tax-dmv|dmv-bank|bank-fee|fee-etc
hey-guy|need-help|low-rpm|epc-light|little-gas|low-rpm|mph-down|low-rpms|slowly-lose|lose-power|epc-light|check-engine|engine-light|p0341-camshaft|camshaft-position|position-sensor|circuit-range|range-performance|performance-bank|single-sensor|check-engine|engine-light|camshaft-position|position-sensor|crankshaft-position|position-sensor|sensor-change|bad-clean|throttle-body|body-clean|maf-sensor|little-hand|right-direction
harley-family|dyna-street|street-bob|.5k-mile|great-shape|look-like|great-deal|silly-question
day-come|unknown-mod|mod-dealer|discover-today|remote-start|aftermarket-remote|alarm-button|button-prime|glow-plug|trunk-button|button-start|bit-finicky|run-completely|completely-remotely|electrical-issue
fun-try|infotainment-screen|actually-use|second-page
charge-port|model-s|s-click|service-center|center-close|long-way|way-tomorrow|charge-overnight|click-noise|usually-mean|probably-pry
intake-chamber|chamber-stay|stay-bracket|intake-manifold|transmission-kickdown|kickdown-throttle|throttle-cable|fuel-line|size-bolt|solved-m8x1.25
accent-hatchback|little-cover|hour-search|think-maybe|accents-come|cargo-cover
+-hyundai|hyundai-sonata|sonata-sport|tech-package|m-down|price-differ|car-gurus|bank-lady|come-down|good-deal|internet-price|_url_-_url_
wrx-base|base-model|model-later|stock-speaker|trash-maybe|maybe-moreso|subaru-sell|package-door|door-speaker|speaker-tweeter|tweeter-subwoofer|gcs-apex|apex-v2|v2-android|android-unit|complement-eachother|stock-speaker|aftermarket-speaker|inline-amplifier
wrangl-sport|early-tonight|engine-start|interior-light|interior-overhead|overhead-light|turn-signal|high-beam|windshield-wiper|like-crazy|work-fine|fine-include|c-radio|look-like
car-second|second-mazda|small-scratch|strongly-consider|seat-cover|probably-leave|accommodate-airbag|size-fit|justify-cover|brand-fit|good-quality|quality-etc|huge-issue|issue-obviously|spend-thousand
occasionally-hit|dirt-road|street-tire|m-run|look-cool
email-monoprice|permanent-modification|faulty-thermistor|heat-block|bed-thermistor|thing-bad|good-case|case-scenario|work-v1|thermistor-replacement|fine-print|kinda-wish|new-heat|heat-bed
seat-cover|leatherette-seat|sweaty-body|neoprene-cover
hey-guy|currently-look|winter-tire|ecoboost-premium|upcoming-winter|zr20-99y|20x9-wheel|feel-pretty|pretty-comfortable|comfortable-choose|blizzak-ws80|cheap-set|p3-sport|sport-edition|edition-18x8|tire-wheel|wheel-tpm|basically-hold|selection-process|feel-confident|compatible-option|blizzak-ws70|ws70-/50r18|oem-fanblade|fanblade-wheels(sell|choose-tire|prevent-rubbing|brake-line|slight-variation|set-work|cost-benefit|outweigh-spend|completely-new|new-set|thank-edit|stock-wheel|buy-new|order-code|code-64e.|64e.-edit|ford-service|service-center
hey-guy|guy-wonder|plastic-valance|radiator-look|approach-angle
3d-printing|print-lot|process-work|buy-tow|tow-printer|mini-select|select-v2s|v2s-wait|mini-delta|mini-delta|delta-forum|pretty-dead|4th-grade|grade-classroom
fairly-new|subaru-life|downpipe-exhaust|logical-step|boost-controller|controller-intake|tvg-delete
stock-rim|swap-tire|aftermarket-set|summer-tire|subaru-website|wheel-spec|tire-spec|r18-assume|ensure-compatibility|stock-summer|summer-tire|guy-shop|know-amazon|advance-exactly|mind-<|<-$|brief-searching|buy-aftermarket|aftermarket-wheel|month-later
post-photo|day-photo|photo-contest|rules-post|dad-related|related-harley|harley-photo|bike-etc|etc-.|short-caption|est-win|biltwell-bantam|bantam-gloves|battery-tender|tender-plus|plus-charger|1st-place|choice-2nd|2nd-place|good-luck|submit-contest|contest-entry
competition-look|look-like|basically-look|size-sedan|fuel-efficiency|efficiency-price|price-point|point-~$50k|~$50k-+
.3-t|t-previous|previous-owner|owner-pay|turbo-yeah|boost-gauge|gauge-fluttering|read-map|map-pressure|pressure-fast|base-boost|wastegate-actuator|actuator-need|need-adjustment|base-boost
ford-f-|like-old|old-truck|forever-ago|floor-shifter|floor-shifter|shifter-constantly|constantly-jam|appreciate-thank
look-like|new-bike|bike-come|different-dynas|wide-glide|xxx-mile|xxx-mile|price-range|low-mile|wide-glide|pretty-appealing|mid-control|current-sportster|bit-short|slow-down|new-bike
cd-changer|changer-keep|keep-try|change-cd|cd-changer|changer-completely|try-press|keep-kill|consider-change
tdi-jetta|jetta-home|loud-pop|accelerate-hard|stop-hard|gingerly-drive|mile-home|suspension-component|small-rock|low-suspension|problem-solve
small-oil|oil-leak|week-ago|trust-shop|uv-dye|oil-tank|look-like|small-leak|rear-main|main-seal|oil-level|oil-sealant|down-fix|thank-guy
couple-month|month-ago|new-exhaust|gm-borla|borla-exhaust|borla-atak|flowmaster-super|nice-happy|happy-sound
jetta-se|intermittently-stall|stall-start|start-fine|fine-cold|die-randomly|check-engine|engine-light|obd2-scanner|scanner-read|engine-die|fuel-pump|obd2-code|dashboard-light|light-warning|fuel-pump|pump-relay|fusediagrams.com-site|fuel-pump
e60-m5|test-drive|depth-buyer|buyer-guide|preferably-video|common-issue|test-drive|year-model|pleasure-driving|daily-driver|currently-drive|e60-535i
local-garage|low-control|control-arm|inner-tie|tie-rod|cad-quebec|plus-instead|university-student|pretty-manual|love-work|safe-simple
gt-hatch|hatch-manual|machine-grey|dealer-down|tax-title|nice-step|11mpg-new|new-tech|lot-easy|park-haha|m-excited
wrx-sti|year-round|round-car|snow-tire|hp-difference|c4-live|look-mainly
half-ago|little-accident|light-turn|turn-green|way-straight|start-turn|turn-left|rear-driver|jeep-mechanic|mechanic-look|wheel-balancing|brake-hard|constant-noise|speed-depend|tilted-hub|balancing-machine|intermittent-squeak|brake-pedal|pedal-slightly
personally-like|108-k|k-lie|lexus-gs|gs-f|odd-reason|reason-lexus|lexus-decide|f-lineup|model-year|200-t|annoying-hump|odd-way|way-lexus|lexus-fit|awd-system|200-t|200-t|bit-lack|i4-t|work-hard|hard-vs|.5l-v6|200-t|10-k|k-extra|extra-50hp|50hp-adjustable|adjustable-suspension|air-suspension
good-idea|bad-idea|visual-purpose|car-negatively|inch-tire|inch-tire|big-engine
long-story|story-short|wrx-cvt|cvt-purchase|edmonton-canada|live-350|350-km|km-away|regular-maintenance|38k-km|fairly-new|oil-change|trouble-start|500-m|engine-rev|oil-level|obviously-need|check-gas|gas-cap|cap-look
hi-friend|wrangler-community|hypergreen-color|basically-brand|brand-new|car-paint|car-value|decently-new|new-jeep
correct-sub|softail-slim|slim-black|black-non|non-ab|chicago-land|land-area|good-otd|otd-price|invoice-price|reasonable-deal
hey-reddit|time-subaru|subaru-owner|impreza-hatchback|brand-new|new-car|new-car|manuel-transmission|list-keep|keep-grow|good-place|upgrade-and/or|loud-exhaust|famous-subie|subie-rumble|y'all-thought
sound-intermittently|intermittently-indicate|timing-chain|chain-guide|guide-tensioner|near-future|good-price|2k-include|new-stuff|stuff-labor|compare-vw|vw-want|perfectly-good|good-low|low-mileage|mileage-vin|vin-code|code-matching|matching-replacement|replacement-engine|timing-kit|125k-mileage|mileage-block|new-timing|low-mileage|mileage-replacement|replacement-engine|new-engine
standard-ford|ford-sync|new-ford|ford-sync|sync-replace|typically-cost|guy-think
wrx-owner|unfriendly-people|solid-car|honda-accord|speed-away|know-right|wrx-owner|sport-car|angry-subaru|subaru-owner
vw-golf|golf-mk6|fully-depress|seat-fully|fully-forward|far-forward|155-cm|cm-tall|inseam-floor|think-floor|vw-golf|golf-mk4|steering-wheel|wheel-length|thereabout-people|people-drive|drive-vw|vw-golf|clutch-stop
try-replace|fuel-system|fuel-pump|fuel-pressure|pressure-sensor|plug-ignition|starter-relate|relate-fuse|pretty-close
blank-plate|fog-light|break-driver|pass-nh|nh-state|state-inspection|fog-light|light-work|interior-coating|fall-apart|apart-bulb|wiring-harness|cut-away|new-harness|blank-plastic|plastic-plate|hole-leave|removed-fog|fog-light|currently-search|random-picture|bumper-fog|fog-light
old-post|sport-sedan|pricey-nav|mean-time|good-mount|mount-location|vent-mount|open-space|mount-recommendation|currently-look|scosche-magnetic|magnetic-mount
default-setting|dedicated-navigation|navigation-button|adjust-setting|connect-easy|easy-fast|select-audio|audio-media|scroll-past|fm-pandora|sirius-xm
edit-approved|super-excited|car-purchase|suuuuuper-excited|manual-transmission|test-drive|gx-gs|gt-today|sticker-price|dealer-nearby|invoice-price|phone-play|play-hardball|originally-talk|good-deal|deal-cause|time-negotiate|guy-think|good-deal|average-deal
service-manual|actually-tell|clutch-stuff|18-mm|no-ronnie|enumerate-list|service-manual(s
recently-purchase|purchase-eono|eono-ca8163r|google-assistant|external-mic|work-correctly|bt-enable|google-app
new-owner|s-alot|m-sure|change-body|body-panel
sighting-thread|r-teslamotor|vanity-post|vanity-post|post-like|tesla-birthday|birthday-cake|hour-ago|r-teslamotor|post-generate|actual-fruitful|fruitful-discussion|mod-rule|weekly-experience|experience-thread|new-post|r-teslamotor|r-teslamotor|great-place|value-significantly|good-interesting|interesting-discussion|discussion-disappear|lose-depth|r-teslamotor|hour-ago|content-look|model-x|red-model|deliver-tesla|tesla-model|model-s|s-model|model-add|chicago-car|car-clog|supercharger-new|new-tesla|tesla-service|service-center|center-picture|picture-jeremy|jeremy-clarkson|clarkson-comment|self-drive|model-s|wagon-model|config-access|tesla-birthday|birthday-cake|cake-model|model-x|restaurant-model|model-s|s-change|fremont-carpark|carpark-got|model-x|x-today|today-supercharger|supercharger-nearly|nearly-online|model-x|x-taxi|taxi-discussion|revamp-model|model-s|battery-got|model-s|s-today|highlight-post|think-fall|vanity-post|lose-real|real-estate|good-discussion|nbsp-thoughts|nbsp-nbsp|nbsp-note|weekly-q&a|q&a-thread|low-reply|weekly-post|look-like|little-visibility|relatively-important|important-discussion
fully-down|rabbit-hole|hole-solar|house-level|charger-powerwall|install-soon|soon-hopefully|northern-san|san-diego|diego-supercharger|cordial-lining|drove-let|eye-contact|car-wait|place-clearly|clearly-design|near-available|available-charger|hello-anxiety|amazing-piece|car-connect|free-limit|wait-list|list-program|supercharger-location|message-pop|available-charger|y-n|press-y|teslas-wait|stall-1b|start-charge|charger-space|message-like|real-issue|ice-spot|hope-people
half-later|vehicle-purchase|tj-obligatory|obligatory-picture|jeep-life|absolutely-wonderful|hid-headlight|fog-light|work-fine|head-light|vice-versa|steering-wheel|stick-come|steering-wheel|knob-stick|stick-indicator|indicator-light|light-result|flash-bright|fog-light|fog-light|indicator-light|pretty-awkward|strange-electronic|electronic-department|blinker-fail|work-fine|forum-post|fuel-pressure|no-long|long-find|forum-post|remote-ignition|ignition-setup|setup-start|high-gear|center-console|great-effort|actually-turn|quarter-turn|turn-clockwise|good-effort|user-error|gear-grind|previous-owner|mean-floor|clutch-shift|slightly-release|clutch-floor|clutch-shift|preventative-maintenance|maintenance-replace|replace-fluid|fluid-etcetera|junkyard-door|previous-owner|instal-lock|door-hinge|new-door|door-unlock|worth-steal|rear-window|window-unzip|feel-like|real-lock|good-course|youtube-video|door-apart|situation-correctly
throttle-body|cb-antenna|trailer-light|light-stop|stop-work|cb-antenna|work-trailer|trailer-light|improper-installation|cb-antenna|trailer-light|cb-antenna|big-road|road-trip|trailer-light|cb-antenna|antenna-mount|trailer-light|light-stop|stop-work|tail-light|mount-require|tail-light|light-assembly|convenience-disconnect|tail-light|light-assembly|critical-step|electrical-plug|tail-light|light-assembly|cb-antenna|antenna-mount|mount-bolt|quarter-panel|panel-cut|sharp-edge|edge-jeep|strategically-place|place-inside|taillight-assembly|cb-antenna|antenna-mount|mount-completely|taillight-assembly|simply-guess|plug-come|taillight-assembly|come-time|trailer-light|big-road|road-trip|run-late|extremely-hot|hot-day|entire-family|big-error|trailer-light|finally-figure|blow-away|taillight-assembly|accidentally-switch|trailer-light|light-inexplicably|inexplicably-stop|stop-work|work-check|weekend-trip|success-despite|minute-delay|delay-start
family-member|w209-clk550|add-bluetooth|v60-port|center-console|car-motorola|motorola-cpt9000|cpt9000-port|little-trouble|trouble-find|bluetooth-adapter|little-difficult|find-optional|year-old|old-car
buy-mustangs|reason-regardless|fox-body|teenage-year|ford-bring|pantie-wet|camp-lejeune|beautiful-fox|fox-body|resale-lot|like-right|exact-fox|fox-body|number-match|match-ford|ford-mustang|mustang-gt|motor-rebuild|past-january|forge-crank|beam-connect|connect-rod|comp-camshaft|port-e7|e7-head|head-edelbrock|intake-manifold|street-demon|multiple-clutch|clutch-cable|cable-clutch|clutch-pressure|pressure-plate|plate-motor|motor-mount|air-conditioning|picture-_url_
unfortunate-run|piece-circle|try-look|correct--57731aj680|recommend-place|look-like|complete-noob|m-hope|quick-fix
pretty-good|good-deal|work-hard|factory-warranty|include-detail|detail-lifetime|lifetime-drive|drive-train|paint-warranty
maybe-help|useful-information|santa-fe|crdi-2wd|2wd-diesel|problem-cause|seemingly-random|random-moment|local-garage|error-code|code-u0009|odb-ii|ii-reader|additional-information|information-point|actual-cause|experience-symptom|sudden-engine|engine-stall|random-time|speed-gear|gear-outside|engine-temperature|clutch-usage|manual-transmission|random-time|spray-startpilot|brake-disk|disk-cleaner|air-filter|no-matter|slow-traffic|warm-day|2-mph|car-suddenly|suddenly-regain|regain-power|shoot-forward|huge-cloud|thick-black|black-smoke|smoke-come|fuel-line|fuel-line|fuel-injector|fuel-filter|filter-clean|fuel-filter|fuel-tank|egr-clean|glow-plug|plug-functioning|starting-problem|battery-healthy|low-voltage|cause-error|error-code|glow-plug|glow-plug|trouble-start|fuel-injector|car-start|local-garage|garage-find
low-ball|ball-joint|joint-replace|240k-mile|year-ago|small-stuff|local-shop|big-job|job-time|time-belt|belt-axle|axle-seal|toyota-owners|owners-website|maintenance-record|open-safety|safety-recalls|special-service|service-campaigns|sound-like
shiba-inu|rear-barrier|seat-cover|work-fit|hammock-style|style-rear|rear-seat|seat-cover|travel-easier
seat-bracket|entirely-sure|motor-adjust|adjust-heating
hey-guy|look-literally|active-sub|factory-sub|rca-wire|active-sub|think-standard|standard-speaker|speaker-wire|new-sub|amateur-question|old-vectra|aftermarket-stereo
day-thing|print-perfectly|problem-nearly|little-bit|build-plate|big-clump|filament-stick
literally-wash|good-care|250kish-mile|torque-converter|converter-issue|main-ride|fishing-hunt|hunt-vehicle|beach-down|galveston-tx|deer-hunting|hill-country|hunting-vehicle|standard-lift|lift-tire|stock-setup|gear-need|big-tire|rear-bumper|fun-vehicle|enjoy-ture|nice-keep|keep-forever|forever-vehicle
mazda3-s|s-hatch|pretty-hard|nearly-ready|rear-brake|stoptech-drill|drill-slot|slot-rotor|posiquiet-pad|individual-component|rear-brake|later-date|potentially-dangerous|dangerous-situation|brake-balance
car-market|honda-train|thing-clear|honda-acura|acura-fast|super-tune|mod-like|like-new|new-wheel|wheel-suspension|suspension-maybe|nice-exhaust|coupe-route|panda-esque|esque-scheme|white-paint|paint-job|black-wheel|wheel-honda|honda-logo|logo-etc|etc-.|chick-magnet|second-look|finish-college|new-model|paddle-shifter|idea-suggestion
saab-life|door-se|se-coupe|sc-wife|s-vert|se-yea|like-gm|gm-saabs|aux-bt|bt-adapter|adapter-fine|music-shit|year-old|freakishly-tall|rear-passenger|tall-people|want-awd|new-cuv|low-mileage|mileage-saab|saab-like|amazing-reliable|reliable-car|3rd-saab|saab-life|looking-time|official-app|read-page|saab-post|probably-copy|copy-paste
odyssey-today|pilot-ex\-l|ex\-l-awd|transmission-good|pilot-tour|tour-fwd|shift-awkwardly|sensing-system|current-toyota|toyota-sienna|sienna-van|sd-card|kid-like|folder-navigation|linux-guru|love-\(no|\(no-offense|wifi-connect|connect-hard|hard-drive|drive-like|wd-model|connected-thumb|thumb-drive|odyssey-elite|\-spee-transmission|bit-worried|res-question|new-subaru|subaru-ascent
hey-guy|e46-bmw|bmw-m3|smg-pump|pump-faulty|faulty-rod|rod-bearing|crack-subframe|mainly-want|/quarter-mile|mile-time|routine-maintenance|good-tune|tune-exhaust|exhaust-intake|body-mod|particular-budget|budget-restriction
second-car|volvo-s70|year-ago|old-car|repair-eventually|drive-new|new-car|car-recently|s70-honestly|favorite-car|currently-drive|honda-civic|embarrassing-old|strange-noise|expect-headache|expensive-repair|fairly-young|young-professional|good-steady|steady-job
hey-guy|right-direction|energizer-500w|500w-power|power-inverter|work-truck|chevy-silverado|silverado-basically|red-fault|fault-light|blue-normal|normal-light|red-fault|fault-light|little-annoying|12v-plug|plug-replace
little-background|micro-sd|sd-card|card-change|ejection-yes|yes-select|select-eject|original-file|previously-save|save-desktop|desktop-folder|sd-card|start-print|print-b|select-b|cancel-print|print-b|file-c|c-d|sd-card|select-print|select-b|print-c|select-e|format-card
auxiliary-fan|bmw-540i|mishimoto-fan|fan-lie|wire-connector|wire-fan|ground-black|constant-power|small-yellow|yellow-red|red-wire|fan-speed|mixed-answer|yello-red|red-wire|edit-solve
couple-month|major-difference|early-year|good-year|.3l-version|version-upgrade|extra-kick
1k-mile|new-mercedes|gear-shift|heavy-acceleration|gear-like|american-car|change-gear|damn-reason|m-head|c-class|slowly-enter|fine-interior|look-like|attention-away|dynamic-cruise|cruise-control|constantly-slam|right-lane|quickly-jump|car-sense|bother-slow|slow-down|car-start|start-accelerate|accelerate-right|completely-change|change-lane|actually-bad|lane-assist|garbage-compare|audi-s3|single-exit|bit-surprised|auto-stop|stop-start|start-feature|save-fuel|stop-sign|red-light|start-close|unnecessary-specially|specially-consider|single-time|c43-amg|wash-let|specific-question
gold-bbs|bbs-wheel|rear-fender|easy-way|try-roll|buy-rear|rear-coilover|coilover-set|cheap-end
vehicle-start|second-thought|guy-think
couple-post|post-similar|specific-question|background-information|seriously-consider|consider-purchase|new-model|model-x.|early-reservation|reservation-30|30-k|look-like|wife-dog|dog-child|child-trip|east-harlem|current-car|garage-near|nearby-lot|primarily-use|northern-ct|southern-new|new-hampshire|specific-question|autopilot-leave|regularly-encounter|test-drive|supercharger-station|preferred-route|route-typically|nyc-want|salesperson-tell|free-supercharging|parking-service|city-typically|typically-queens|charge-station|viable-option
couple-time|portable-evse|240v-charge|charge-station|volt-sense|240v-charger
online-researching|researching-maybe|hertz-dealer|rental-car|extended-warranty|fidelity-warranty|tucson-se|great-look|look-car|car-ride|ride-great|great-look|look-like|perfect-car|extended-warranty|bumper-coverage|add-mile
local-home|home-depot|key-fob|car-button|button-push|completely-dead|week-old|ridiculously-wave|car-like|like-harry|harry-potter|unresponsive-tesla|finally-place|secret-windshield|windshield-spot|door-release|trusty-service|service-center|home-depot|reply-yes|zealous-cell|cell-tower|cellular-and/or|wireless-security|security-system|system-sensor|cellular-paging|~300mhz-spectrum|similar-problem|readily-noticeable|noticeable-antenna|antenna-array|array-nearby|fob-stop|stop-work|environmental-cause|immediately-switch|service-center|model-x|x-bluetooth|bluetooth-ish
common-compare|3rd-gen|gen-pretty|mile-away|5th-gen|gen-owner|3rd-gen|mental-nod|approval-lol
dl-sedan|cylinder-gasoline|gasoline-engine|automatic-transmission|owner-car|feel-free
prusa-i3|i3-mk3|mpselectmini-v2|v2-wow|half-tempt|half-tempt|thing-look|look-sooo|sooo-nice|small-mod|glass-bed|glass-cut|local-hardware|hardware-store|store-cut|template-add|add-layer|add-small|small-binder|binder-clip|z-spacer|reliable-bed|bed-adhesion|adhesion-no|no-matter|dozen-fail|fail-print|component-pop
second-guessing|rev2.5-product|rev2.5-product|nut-buy|ebay-instead
recently-buy|brand-new|4runner-sr5|sr5-instantly|black-rim|new-baby|decent-idea|stock-tire|hopefully-cut|total-cost|new-setup|stock-wheel
plastic-door|door-frame|frame-require|require-roof|roof-frame|frame-lock|lock-clip|clip-attach|jk-sport|sport-2dr
number-lease|lease-36mo/|000mi-hyundai|hyundai-ioniq|ioniq-limited|lease-end|1k-credit|prius-value|value-generously|incredibly-eager|consistently-drop|toyota-prius|definitely-intent|lease-end|test-drive|digital-interface|recently-test|test-drive|lexus-ct|ct-200h|absolutely-love|glorify-prius|year-comfortably|greatly-appreciate
second-car|wife-steal|volvo-s60|sweet-spot|compression-gremlin|little-engine
decent-truck|truck-down|4x4-limited|limited-natural|natural-white|white-4runner|285k-mile|highway-mile|include-ttl|truck-look|look-clean|valve-cover|cover-leak|leak-oil|truck-aside|valve-cover|water-pump|time-belt|ski-resort|need-new|new-tire|terrain-tire|tire-handle|brand-new|new-toyo|toyo-at2s|winter-assume
good-morning|time-poster|currently-eyeball|fairly-low|low-mileage|km-approx|look-pretty|pretty-clean|non-audi|audi-dealership|fair-price|fsi-engine|carbon-build|probably-tenfold|carbon-build|later-mys|common-issue|carbon-build|relate-issue|pretty-bulletproof|opinion-appreciate
hello-folk|long-story|story-short|second-car|145000-km|similar-experience
non-turbo|turbo-mazda|recently-pick|basic-mod|buy-speed|non-turbo|completely-different|different-platform|helpful-thank
15k-sport|sport-car|car-like|mr2s-recently|daily-driver|reliable-fun|fun-daily|daily-driver|pacific-northwest|mr2-spyder|performance-difference
hey-guy|wind-rain|rain-deflector|dealer-today|pair-fit|fit-normally|rear-require|sit-correctly|feel-like|piece-bulge|look-_url_|feel-wrong|wrong-bend|look-right|cross-year|year-compatibility
bridge-recently|low-tire|tire-pressure|pressure-light|light-come|gas-station|door-jamb|tpms-system|light-come|sensor-need|year/36k-warranty
big-rim|unique-taste|wave-anymore|totally-understand|understand-people|feel-shitty
second-v1|white-queen|chess-set|queen-print|print-fine|fine-despite|inland-pla|sit-open|bed-surface|bed-leveling|leveling-issue|extrude-fine|little-glob|extruded-layer|let-print|print-run|completely-structurally|structurally-useless|jammed-filament|filament-melt|stale-pla|pla-clog|clog-nozzle|update-definitely|clogged-nozzle|brand-new|new-roll|filament-produce
post-facelift|facelift-manual|state-tennessee|bimmerforum-zhp|zhp-mafia|mafia-craigslist|craigslist-autotrader|autotrader-cars.com
input-suggestion|silverado-work|work-truck|recently-purchase|travel-trailer|camping-spot|backup-camera|perfect-scenario
test-drive|drive-check|seller-run|auto-repair|repair-place|mb-bmw|bmw-volvo|volvo-etc|prev-owner|owner-upgrade|new-car|223k-mile|mile-ac|ac-works|works-antenna|retract-sun|sun-roof|clean-check|check-vin|accident-report|report-seller|month-thing|check-rust|jack-location|location-head|head-number|number-hydraulic|hydraulic-rear|rear-suspension|suspension-thanks
bit-dissatisfied|stock-shifter|mustang-gt|gt-s550|mt82-transmission|mgw-race|race-spec|gold-standard|standard-solution|instead-incrementally|incrementally-upgrade|upgrade-different|good-performance|stock-shifter|warranty-implication|improve-stock|stock-shifter|shifter-assembly|assembly-attachment|stock-trans|trans-mount|mount-steeda|steeda-shifter|shifter-base|base-bushing|whiteline-positive|positive-shift|shift-transmission|transmission-mount|mount-bushing|bushing-insert|stop-gap|half-measure|performance-improvement|shifter-base|base-bushing|bushing-purchase|purchase-obsolete|great-experience|budget-friendly|friendly-modification|bracket-bushing|bushing-upgrade|concurrently-upgrade|barton-shifter|attach-stock|stock-shifter|shifter-assembly|tran-blowfish|blowfish-shifter|shifter-support|support-bracket|guy-link|excessive-nvh|weird-middle|middle-ground|stock-shifter|tran-mount|mount-solid|solid-feeling|tran-attach|attach-mgw|mgw-shifter|shifter-mgw|mgw-race|race-spec|spec-short|short-throw|throw-shifter|option-performance|performance-improvement|cheap-option|option-bad|bad-bang|diminish-return|return-territory|money-spend|regret-jump|appreciate-thank
long-commute|different-car|car-previously|easy-fix|fix-thx
white-wrx|wrx-limit|june-15th|look-recommendation|perrin-shifter|shifter-stop|buy-jdm|jdm-drl|drl-fog|fog-light|light-bezel|correspond-harness|c-light|light-drl|crack-open
car-_url_|_url_-sort|new-car|sedan-civic|civic-si|generally-curious|remotely-realistic|low-mile|mile-like
subaru-wrx|wrx-112k|112k-mile|mile-stock|new-slotted)rotor|yrs-past|past-60k|60k-mile|growling-noise|noise-feel|steering-wheel|popping-noise|highway-speed|passenger-wheel|wheel-sound|sound-like|rough-pavement|slight-bump|bump-like|10k-mile|mile-leave|leave-brake|fine-alignment|multiple-time|rear-wheel|wheel-bearing|10k-mile|mile-ago|little-concern|high-way|colder-weather|weather-come|break-down|far-point|cv-joint|wheel-bearing|maybe-tie|tie-rod|thank-r|r-subaru|help-edit|edit-update|cv-joint|joint-issue|look-people|makeshift-tool|tool-update|change-ball|ball-bearing|bearing-reduce|inspect-cv|cv-find|keep-look
c350-coupe|coupe-currently|stagger-wheel|winter-tire|cost-effective|effective-option
new-mb|mb-a180d|bussiness-pack|option-add|smartphone-connectivitypack|describe-android|android-auto|play-music|car-sorry|newbie-question
day-ago|lurch-forward|slow-down|error-code|transmission-fluid
phone-settings|volt-automatically|automatically-pair|pair-phone|phone-list|infotainment-owner|sound-correct
_url_-_url_|_url_-_url_|_url_-_url_|week-ago|surprisingly-sunny|year-ago|trash-bin|bin-junk|drive-plus|search-look|stuff-like|like-old|old-ford|ford-rangers|rangers-f-150s|f-150s-exploders|exploders-etc|etc-.|thing-hold|total-wreck|nice-ratio|single-previous|previous-owner|good-shape|crazy-low|low-mile|look-like|weathertech-floor|floor-mat|original-asking|asking-price|extra-vehicle|need-pump~~|alignment-wheel|wheel-balance|radio-steering|steering-wheel|wheel-button|delaminate-replace|replace-radio|support-aux|stupid-air|air-suspension|_url_-_url_
work-intermittently|start-drive|work-fine|abs-fuse|abs-module|speedometer-problem|problem-begin|day-ago
month-ago|second-ms|sale-agent|agent-try|perfect-fit|fit-ready|old-car|car-right|later-find
look-like|club-style|style-bobber|d-like|cam-valve|spring-carb|carb-exhaust|d-like|solo-seat|crazy-expensive|t-bar|bar-like|like-lucky|lucky-dave|t-bar|iron-head
currently-consider|sport-package|package-manual|manual-mile|ask-11k|worthy-buy
new-home|outlet-instal|charger-instal|good-type|tesla-charger|standard-outlet|amp-installation|cheap-etc|etc-?|total-cost
odb2-code|look-online|different-fix|gas-pedal|throttle-body|natter-tray|definite-answer
-up-seat|wife-comfortable|stop-short|short-guy|guy-problem|sd-seat|somewhat-high|h-d|d-world
car-today|faint-de|ignition-brake|brake-lock|strange-whir|whir-noise|noise-come|dome-light|loud-version|forum-search
gather-information|tow-hitch|trunk-space|spare-tire|tire-compartment|u-haul|haul-sell
conflict-information|play-video|sd-card|specific-format|a4-premium|play-audio|support-video|video-format|000kbps-bitrate|bitrate-720x576|720x576-resolution|maximum-25fps|try-exactly|high-trim|trim-level|specific-package|video-playback|video-playback|asterisk-indicate|certain-trim|trim-package|convenience-package|package-instal|reprogram-hack|hack-enable|enable-video|legit-way|play-video
hey-guy|print-warp|warp-issue|issue-today|buy-glass|glass-cut|2-mm|mm-spacer|glass-2|2-mm|rub-alcohol|glue-stick|warping-post|day-ago|try-safety|safety-razor|razor-blade|blade-spatula|try-spritz|rub-alcohol|print-try|magic-trick
video-_url_|sonata-beep|whistle-like|try-toggle|air-recycle
lexus-is350|long-time|terrible-driver|car-survive|survive-multiple|multiple-year|drive-lexus|is200-t.|bmw-dealership|test-drive|car-drive|m240-drive|fun-car|probably-way|car-gets|gets-total|cpo-car|car-available|literally-sell|sale-guy|guy-tell|metallic-grey|25k-mile|test-drive|tad-bit|bit-slow|look-outdated|look-modern|good-condition|day-drive|informed-decision|emotional-buy|low-mileage|mileage-oil|oil-change|highly-recommend|bmw-report|look-like|hit-18k|18k-mile|huge-issue|red-flag|oil-change|common-thing|original-warranty|car-expire|cpo-expire|buy-extended|extended-coverage|sale-guy|guy-tell|extended-coverage|cover-brake|brake-pad|read-online|extend-warranty|brake-pad|purchase-extended|extended-warranty|original-warranty|warranty-end|cpo-warranty|warranty-end|final-question|good-price|dealer-originally|33k-today|exactly-35k|35k-otd|list-option|basic-spec|lease-return|exterior-color|color-mineral|mineral-grey|grey-metallic|metallic-interior|interior-leather|leather-black|black-red|red-highlight|highlight-stitching|stitching-odometer|odometer-25k|25k-rwd|rwd-sport|sport-line|line-premium|premium-package|package-technology|technology-package|package-co2|co2-relevant|relevant-vehicle|vehicle-sport|sport-automatic|automatic-transmission|transmission-tire|tire-pressure|pressure-monitor|monitor-alarm|alarm-system|system-universal|universal-garage|garage-door|door-opener|opener-moonroof|lines-designation|designation-moonroof|moonroof-floor|floor-mat|mat-auto|auto-dim|dim-mirror|mirror-auto|auto-dim|dim-rearview|rearview-mirror|mirror-power|seat-split|split-fold|fold-down|down-rear|rear-seat|seat-storage|storage-package|package-heated|seat-anthracite|anthracite-wood|wood-trim|trim-highlight|highlight-trim|trim-finisher|finisher-pearl|pearl-blow|heater-park|park-distance|distance-control|control-rain|rain-sensor|auto-headlight|headlight-xenon|xenon-headlight|headlight-adaptive|adaptive-light|light-control|control-automatic|automatic-climate|climate-control|control-ambient|ambient-lighting|lighting-additional|-v-power|power-socket|socket-harman|harman-kardon|kardon-surround|surround-sound|sound-dvd|dvd-area|area-code|code-na|na-bmw|bmw-teleservices|teleservices-teleservice|teleservice-control|control-cic|cic-contribution|contribution-m|m-sport|sport-suspension|suspension-increase|speed-limiter|limiter-variable|variable-light|light-decode|decode-teleservice|teleservice-activation|activation-oil|oil-chg|chg-15k|15k-miles/|miles/-month|month-daytime|daytime-drive|drive-light
preheat-mode|temperature-reading|consistently-freeze|target-temperature|late-firmware|display-change
recently-buy|great-deal|deal-close|grille-design|major-thorn|nigh-unusable|android-auto|auto-interface|midrange-android|android-device|device-moto|moto-phone|caller-report|choppy-spurt|android-auto|head-unit|unit-function|function-perfectly|android-device|phone-right|run-android|android-nougat|android-auto
crazy-idea|inch-spacer|spacer-lift|tj-sport|cyl-automatic|tube-fender|gearing-braking|braking-sye|cheap-plan|brake-upgrade|slowly-add|lcog-rig|sand-dune|minor-rock|rock-crawl
carry-aftermarket|recent-year|year-generally|day-plus
car-rough|rough-idle|turbo-surging|weak-acceleration|dirty-throttle|local-mechanic|coil-ignition|error-code|code-come|fast-forward|throttle-body|good-cleaning|cleaning-look|pcv-valve|slight-snag|broken-end|old-hose|don;t-know|throttle-body|simple-fix
cls-lease|end-soon|past-week|current-402hp|daily-driving|basically-load|designo-selenite|selenite-grey|grey-magno|magno-color|hear-mixed|mixed-opinion|look-amazing
horribly-transparent|powerwall-installation|welp-got|got-instal|backup-power
red-light|accidentally-push|parking-brake|brake-button|car-kind|continue-rolling|parking-brake|brake-light|light-come|car-automatically|automatically-disengage|feel-like|complete-idiot|honest-accident
dome-light|switch-break|stage-switch|door-open|dealership-want|google-search|find-replacement|entire-unit
hello-harley|k&n-performance|performance-air|air-intake|power-commander|commander-v|dyna-superglide|superglide-custom|surely-keep|keep-add|add-piece|extra-pep|dyno-schedule|improve-performance|edit-forgot|scream-eagle|eagle-ii|ii-pipe
gear-speed|speed-rpms|main-concern|wheel-come|regular-thing|dirt-bike
replacement-block|good-condition|different-imprint|original-block|easy-way
brake-pedal|bleed-valve
anonymous-neighbor|model-s|definitely-lock|walk-away|away-enable|technical-support
stock-clutch|gt-idk|period-thing|sound-clunky|engagement-point|gt-clutch|drive-manual|genuinely-feel|feel-like|user-error|low-gear|stock-clutch|clutch-feel|steeda-assist|assist-spring|big-difference|similar-experience
pacific-northwest|rain-instead|constant-snow|rainy-climate|climate-keep|stay-cold|pnw-couple|multiple-thing|stay-unmoved|cause-mold|seat-wet|rainy-climate|rampage-frameless
definitive-answer|track-rex|daily-drive|3k-mile|drive-pretty|pretty-conservatively|cobb-stage|accessport-tune|track-drive|real-power|power-mod|reccomend-spring|spring-strut|coilover-etc|etc-.|ride-quality
roll-cage|good-search|search-term|term-etc|chevy-blazer|stock-fiberglass|fiberglass-shell
tail-light|tail-light|drag-specialty|custom-dynamic|little-happy|guy-run|stupid-bright|bright-ambulance|ambulance-tail|tail-light
new-vehicle|favorite-option|hard-time|time-hone|afford-~30k|vs-new|issue-buy|gt-vs|vs-v6|v6-gt|gt-sound|sound-amazing|premium-vs|extra-cost|d-want|unique-interior|surround-system|premium-cost|bloat-price|price-far|base-gt|gt-simply|keep-cost|cost-down|manual-vs|vs-standard|daily-driver|big-congested|congested-town|town-houston|close-family|family-member|member-suggest|suggest-automatic|feel-like|manual-truck|hella-heavy|bad-traffic|annoying-tho|avoid-traffic|stripe-cheezy|offcentered-stripe|stripe-esp|white-white|white-platinum|platinum-car|convertable-?|absolutely-worth|v6-convertable|convertable-manual|d-appreciate
print-large|large-thing|warp-away|bed-especially|build-internally|raspberry-pi|pi-case|print-today|today-_url_|bed-warm|warm-running|bed-set|glue-stick|hatchbox-pla|edit-forgot|print-flat|start-curl
m-consider|porsche-panamera|panamera-model|model-year|beautiful-sport|sport-steering|steering-wheel|nice-seat|alcantara-nice|nice-exhaust|extra-horsepower|gts-especially|nice-steering|steering-wheel|pay-15k|pretty-steering|steering-wheel|steering-wheel|wheel-later
consider-buy|a4-w|w-t|t-quattro|-speed-gearbox|ultra-quattro|rear-lsd|differential-open|sport-differential
engine-mode|high-pitch|pitch-whine
week-ago|new-malyan|malyan-m200|calibration-cube|good-print|bit-hilly|printer-lay|lay-down|2nd-layer|stock-pla|second-question|like-cork|similar-material|fr4-plate
currently-drive|accord-lx|324-k|axle-o2|o2-sensor|ball-joint|eventual-replacement|poor-rating|current-gen|gen-civic|civic-ex|ex-t|expect-reliability|heart-set
m3-gt|gt-hatchback|tie-down|down-hook|spare-tire|buy-separately
trouble-decide|a4-premium|mile-white|white-a4|a4-premium|mile-black|trouble-decide|follow-reason|white-color|wood-interior|low-milage|long-life|life-span|little-iffy|time-correct|low-milage
civic-total|suzuki-swift|overall-rebuild|rebuild-mod|rear-wheel|wheel-wheel|wheel-cut|new-section|section-weld|month-ago|transmission-explode|case-break|shifter-linkage|lack-5th|long-trip|fairly-thorough|thorough-craigslist|craigslist-hunt|aero-w/130k|w/130k-mile|owner-dealer|dealer-maintain|little-waggling|fair-price|fair-share|near-perfect|lip-rear|rear-spoiler|roof-rack|hour-detail|wash-clay|clay-bar|bar-wax|wax-trim|trim-interior|interior-engine|nice-weekend
hey-folk|allen-head|head-bolt|exhaust-stud|actual-exhaust|exhaust-stud|bolt-break|obvious-answer|nut-weld|near-chopper|chopper-shop|shop-straight|work-welding|welding-place|insane-price|distant-mechanic|red-loctite|insane-welder
stock-tweeter|stock-location|m-hope|illusion-audio|audio-fit|stock-corner|corner-dash|dash-location|location-crutchfield|crutchfield-website|sorta-far|personally-look|find-diagram|speaker-diameter|diameter-mount|mount-depth|depth-require|sorta-thing
vw-gli|nice-daily|daily-driver|x1-xdrive35i|535i-wagon|328i-wagon|reliable-n55|bit-weary|328i-wagon|ol-reliable|key-option|cargo-space|suv-sorta|sorta-thing|kinda-small|remember-correctly|year-ago|lbs-muscular|carry-gym|gym-equipment|equipment-regularly|waste-money
recently-acquire|new-truck|truck-shell|sweet-door|small-hatch|hatch-style|style-door|door-embed|kinda-like|like-doorception|original-door|original-hinge|previous-owner|literal-interior|interior-door|door-hinge|original-inset|factory-hinge|hinge-remain|right-hinge|inset-_url_|_url_-apology|horrify-reflection|yeti-like|like-arm|arm-cheer
extrusion-issue|fairly-spongy|spongy-print|print-lately|little-extrusion|extrusion-knock|error-cause|solid-smooth|smooth-surface|bad-print|kapton-tape|print-head|poor-insulation|hot-end|insolation-like|high-temp|temp-insulation|insulation-like
passat-variant|aftermarket-head|head-unit|possibly-android|android-car|bus-gateway|battery-drain|aftermarket-unit|original-unit|unit-specifically|hack-firmware|original-unit|new-unit
day-round|round-trip|mpg-average|effectively-tripple|gas-milage|milage-come|honda-element
volt-lt|little-thing|thing-annoy|wiper-leave|huge-untouched|untouched-spot|glove-box|box-middle|middle-seat|rear-vent|great-car|time-tonight|head-outside|quick-peak|9-pm|degree-celsius|cool-down
hey-guy|post-like|325xi-accident|accident-free|000-km|old-style|car-look|trust-mechanic|stay-away|automatic-transmission|thank-guy
set-screw
power-indicator|dash-maxe|gas-engine|electric-motor(s|max-power|artificial-limitation|limitation-impose|engine-control|nice-round|round-number|number-regardless|hybrid-mode
v6-2wd|owner-southern|southern-vehicle|taxis-title|title-etc|etc-.|.2k-cash|unrealistic-expectation|current-market|4th-gen|gen-recently|update-sure|dealer-counter|counter-offer|couple-day|help-guy
fly-rock|rock-chip|chip-paint|driver-door|chip-paint|hood-area
b7-a4|manual-tran|carbon-cleaning|upgrade-hp|hp-fuel|fuel-pump|pump-cat|new-version|turbo-bypass|bypass-valve|valve-coil|coil-pack|pack-low|low-temp|temp-spark|spark-plug|plug-drill|drill-slot|slot-rotor|rotor-b|b-c|look-cool|pcv-catch|high-flow|flow-cat|timing-belt|belt-clutch|clutch-chain|rattle-new|new-motor|motor-mount|mount-change|diff-fluid|fluid-oil|oil-change|5k-ect|basic-maintenance|maintenance-item|thing-instal|ecm-reflash|close-dealer|cost-wise|fall-close|tell-apr|drive-able|able-tune|little-conservative|helpful-unitronic|hpfp-tune|claim-275hp/310tq|aggressive-tune|look-fun|cold-new|new-england|england-winter
mud-bogging|practically-clean|toyota-tundra|tundra-stock|stock-wheel|p245/70r16-tire|factory-fender|fender-flare|pretty-danged|danged-wide
recommend-tire|tire-brake|brake-fluid|occasional-track|track-day|guess-probably|safely-learn|short-time|recent-purchase|think-excellent|excellent-sight|sight-line|underrated-quality|fast-car|technical-standpoint
map-acceleration|acceleration-performance|battery-charge|charge-level|performance-impact|battery-charge|charge-decline|battery-size|size-selfishly|primarily-interested|model-s|s-p90dl|old-model
different-d&d|d&d-mini|mini-model|there(full-credit|good-detail|stray-strand|temp-setting
recently-start|start-look|boxster-cayman|porsche-certify|certify-pre|boxster-s|upgrade-sport|sport-chrono|chrono-bose|bose-bi|bi-xenon|xenon-etc|25k-mile|20k-mile|certify-porsche|certify-porsche|porsche-dealership|northern-california
branch-fall|is350f-yesterday|couple-hour|pretty-minor|chrome-trim|trim-underneath|paint-chipping|actual-dent|hardly-noticeable|pressure-device|body-shop|body-shop|car-ultimately|picture-_url_
stock-bmw|bmw-18inch|18inch-run|run-flat|bmw-435i|recently-introduce|dealer-recommend|recommend-new|new-tire|non-run|run-flat|comfort-reason|road-travel
hey-guy|civic-116|116-k|code-p1457|p1457-evap|evap-system|system-leak|leak-detect|detect-canister|canister-area|area-p0133|p0133-ho2s-|circuit-slow|slow-response|gas-tank|tank-shut|charcoal-canister|canister-area|pretty-handy|help-provide
recently-buy|great-shape|consistent-reading|transmission-dipstick|service-manual|manual-instruction|instruction-park|level-surface|engine-idle|parking-brake|brake-apply|apply-shift|p-position|clean-rag|fluid-level|hot-range|normal-driving|driving-temperature|dipstick-appear|completely-dry|cold-range|add-fluid|proper-level|dipstick-rest|t-iv|iv-atf
right-direction|little-plastic|plastic-catch|center-console|console-arm|arm-rest|rest-down|down-snap|arm-rest|rest-lid|new-center|center-console|mind-find|find-wholesalehyundaiparts.com
mazda3-family|run-v55|v55-firmware|exact-version|dealer-certify|certify-pre|nav-simcard|android-auto|auto-tweak|nav-simcard
recently-swap|stock-mini|mini-ape|luckydaves-sandiego|sandiego-bars|female-harness|harness-plug|mile-away
day-ago|finally-manage|post-mortem|print-pla|completely-burn|close-inspection|heat-block|block-wire|machine-apart|temperature-sensor|sensor-wire|white-plastic|actually-melt|melt-apart|matter-inside|thing-temperature|temperature-sensor|slave-heat|heat-bed|bed-power|power-supply|protect-power|power-strip
hey-guy|fatboy-low|month-ago|ago-completely|completely-stock|stage-mod|mod-intake|intake-cleaner|cleaner-exhaust|v&h-big|big-radius|good-performance|performance-compatibility|performance-calculator
road-trip|bay-area|fantastic-supercharge|painless-experience|highlight-autopilot|autopilot-work|wind-road|way-road|speed-limit|town-autopilot|automatically-reduce|maximum-speed|increase-safety|reduce-driver|driver-fatigue|supercharger-stall|tesla-figure|m-b|b-b250e|public-charging|lane-road|short-straight|straight-stretch|accelerator-hard|engine-noise|hour-drive|control-music|ipod-phone|huge-display|enable-android|android-auto|auto-carplay|lane-change|keep-blink|sort-indicate|indicate-failure|lane-change|ice-car|long-road|road-trip|ice-free|free-soon
mp-select|select-mini|mini-v2|week-ago|print-start|home-axis|nozzle-touch|touch-down|down-twice|thing-a.|a.-attempt|expose-metal|buildtak-b.|b.-repeatedly|repeatedly-ram|home-axis|push-down|gets-catch|provide-hex|hex-tool|print-bed|issue-remain|faulty-gcode|issue-turn|printer-try|try-multiple|multiple-different|different-print|print-attempt|attempt-print|usb-wifi|microsd-clean|clean-nozzle|filament-return|return-printer|factory-setting|wifi-gcode|gcode-ensure|mechanic-component|proper-place|loss-right|issue-appear|small-thing|nice-hatchbox|hatchbox-stuff|noob-mistake|borosilicate-glass|glass-bed|bed-soon|glass-bed|borosilicate-glass
girlfriend-house|battery-light|light-turn|minute-start|thing-happen|keep-happen|couple-minute|check-engine|engine-light
title-suggest|fuel-problem|drive-home|home-today|car-shut|investigate-oil|oil-temperature|fuel-pump|hold-down|sluggish-start|ideal-state|drive-home|diagnostic-reading|screen-read|fuel-pressure|pressure-problem|fuel-filter|filter-fuel|fuel-pump|bit-easy
hi-friend|year-old|old-window|window-weatherstripping|old-saab|basically-impossible|old-vehicle|allow-easy|easy-access|modern-replacement|window-weatherstripping|old-vehicle
huge-storm|car-turn|big-truck|truck-splatter|splatter-ton|try-turn|nasty-noise|foot-brake|sun-try|insurance-come|try-start|noise-like|car-start|gas-smell|smell-smoke
work-anymore|fuse-inside|blink-red|circuit-breaker
little-extra|extra-step|cheap-plastic|plastic-stool|perfect-excuse|jeep-obsession|rock-rail
know-fj80|5th-gen|gen-4runner|holy-shit|love-4runner|consider-sell|land-cruiser|3rd-gen|5th-gen|find-solid|solid-year
holy-smoke|drive-mediocre|mediocre-car|year-finally|finally-bite|decent-motor|pure-traction|world-apart|jeep-yj|yj-especially|drivability-department|post-pic|dark-right|sexy-smoke|smoke-tail|tail-light|turbo-tuesday|tuesday-guy|guy-n|n-gal
mechanic-blind|heavy-hammering|car-start|press-down|gas-hard|drive-fine|process-start
hey-r|r-lexus|employee-discount|toyota-corporate|f-sport|f-sport|sport-package|receive-decent|decent-snowfall|perfect-world|f-sport|pay-sub|sub-40k|edit-thank|help-r|r-lexus|dealer-yesterday|f-sport|nebula-gray
buy-mazda|mazda-itoure|popular-package|package-today|configure-car|car-setting|realize-maintenance|guy-set|schedule-maintenance|maintenance-oil|oil-change|tire-rotation|rotation-question|12v-power|power-outlet|arm-rest
cayman-s|service-oil|oil-change|change-break|break-bowden|bowden-cable|cable-amp;amp;amp|amp;amp;amp-bracket|courtesy-vehicle|late-model|model-ruby|ruby-red|red-infinity|infinity-q60|half-bad|bad-right|sport-sedan|daily-drive|sealy-posturepedic|razor-sharp|sharp-handling|handling-intimate|intimate-road|road-feel|perfect-balance|tight-leather|leather-glove|thick-wool|wool-mitten|no-long|long-dominate|instead-gingerly|gingerly-navigate|navigate-like|olympic-speedskater|speedskater-intently|intently-cross|unmistakable-flat|growl-replace|burble-unique|throttle-response|seemingly-linear|linear-power|power-available|little-happen|moment-later|turbo-spool|foreground-begin|windscreen-like|millennium-falcon|falcon-blasting|catapult-forward|forward-usually|brake-immediately|momentary-pass|pass-opportunity|nice-car|nav-system|system-backup|backup-camera|bluetooth-connection|creature-comfort|later-today|sport-sedan|-speed-automatic|sensation-describe
diesel-volkswagens|low-mileage|controversial-car|stay-away|find-mechanic|pretty-popular|like-find|regional-thing|smart-purchase|understand-vw|maintenance-need|time-car|car-buyer|avoid-vw
astronomical-high|high-tide|tide-associate|winter-storm|east-coast|coast-flood|wrangler-unlimited|claim-adjuster|saltwater-flood|flood-car|total-loss|sentimental-value|sentimental-value|pretty-emotional
c-light|compressor-turn|radiator-look|look-normal|blow-warm|warm-air|sure-exactly|stop-work|window-down|month-ago|slowly-start|wrong-fuse|radio-ac|correct-fuse
early-version|version-circa|model-year|pcs-starting|starting-fully|fully-brake|model-year
pristine-look|look-mercedes|mercedes-benz|benz-c63|c63-amg|brand-new|new-tire|tire-summer|bell-whistle|private-dealer|low-18k|18k-mile|good-condition|guy-want|negotiate-down|guy-think|maintenance-cost
daytime-running|running-light|light-appear|indicator-mean
got-quote|bmw-x5|oil-filter|filter-housing|housing-leak|cpo-warranty|year-ago|initial-repair
chevy-cobalt|clown-car|recently-find|f150-fx4|100k-mile|truck-wise|need-advice
xv-crosstrek|pretty-strange|strange-happen|digital-gauge|gauge-reflect|fuel-light|light-flash|safely-pull|future-referance|like-magic|gas-cap|leak-fuel|respond-normally|fuel-senser|senser-float|fuel-system|need-replace|help-edit|error-code|maintenance-letter|problem-persist
subaru-newbie|recently-pick|jetta-tdi|want-keyless|keyless-entry|remote-start|start-option|brake-light|immediately-check|brake-switch|work-fine|stop-fuse|shift-lever|relay-click|good-place|viper-system|r-s|s-system|completely-unhook|starter-wire|google-fu
community-think|gts-package|ventilate-seat|centerlock-wheel|wheel-yay|nose-lift|lift-yay|metal-sunroof|come-standard|long-wait
tribeca-need|extended-warranty|100k-maintenance|maintenance-loom|local-dealer|dealer-want|guy-think|great-deal|subaru-thank
milk-crate|crate-hold|original-engine|good-bit|miscellaneous-stuff|main-concern|surface-rust|flywheel-inside|maybe-sell|end-rebuild
fresh-lurker|prius-plug|price-point|low-mile|premier-fully|fully-load|minute-away|drive-second|fully-load|lane-departure|departure-warning|collision-warning|state-away|hour-drive|accident-report|quieter-ride|slightly-low|low-ev|ev-range|hint-thought|thought-insight|small-difference|scream-buy
barely-hear|play-normally|radio-model|avh-x2600bt|work-flawlessly|thank-guy
bluetooth-audio|know-problem
mirror-adjustment|adjustment-switch|middle-position)for|mirror-lower|stop-work|finally-look
online-auction|auction-site|dmv-fee|turbo-charge|92k-miles|good-advice
recently-purchase|triple-yellow|yellow-ecoboost|ecoboost-performance|performance-package|appearance-mod
month-ago|instrument-cluster|cluster-light|turn-signal|signal-light|light-flash|start-rip|rip-stuff|stuff-apart|needs-replace
consider-pick|3rd-gen|prefer-purchase|rust-belt|belt-cali|cali-texas|texas-etc|hear-story|story-and/or|and/or-advice|pre-purchase|purchase-question|find-particularly|particularly-helpful|helpful-assumption|pretty-familiar|4runner-family|4th-gen
northern-california|california-surface|huge-leak|know-issue|brake-light|light-foam|foam-gasket|gasket-degrade|time-allow|internal-leak|gasket-unlimited|unlimited-info|google-search|pretty-sneaky|sneaky-leak|leak-check|cargo-hold|tailgate-carpet|carpet-etc|etc-.|.-forewarn|tiny-plastic|f-sport|sport-porn
4wd-limited|-wheel-drive|drive-blink|blink-start|feel-like|moderately-reputable|reputable-garage|electric-motor(s|car-run|new-electric|electric-motor
people-mention|hilly-area|kinetic-energy|logic-dictate|share-drivetrain|drivetrain-loss|regen-conversion|conversion-loss|use-d|d-l|hotly-contest|contest-issue
reliably-increase|print-speed|new-firmware|stepper-motor|openlock-dungeon|dungeon-tile|d&d-campaign|print-time|time-down
premium-compact|compact-car|car-chevrolet|chevrolet-volt|fuel-efficiency|efficiency-improve|improve-electric|electric-range|improved-interior|new-chevrolet|chevrolet-volt|perfect-vehicle|electric-car|car-segment|new-volt|overall-range|range-stylish|stylish-exterior|strike-exterior|>-unlike|electric-vehicle|board-generator|dread-range|range-anxiety|volt-cheap|new-volt|completely-different|previous-model|require-driver
f-sport|sport-exhaust|exhaust-installation|installation-tutorial|installation-come|maintenance-\(such|time-change
low-mileage|mileage-sub|sub-70k|70k-535i|535i-xdrive|xdrive-wagon|final-year|bmw-import|import-thesis|thesis-beast|good-car|error-prone|prone-mechanic|mechanic-bait|second-friendly|friendly-german|dog-ski
big-question|right-away|fresh-fuel|dryer-sheet|keep-mouse|mouse-away|mind-leave|greatly-appreciate|oil-change|couple-week
square-tubing|receiver-hitch|winch-plate|big-problem
mini-ape|drag-bar|need-new|new-cable|try-search|definitive-answer|time-thank
lame-o|subaru-club|club-think|harley-davidson|davidson-fandom|forester-xt|xt-blow|tire-shred|shred-right|end-pretty|pretty-bad|feel-compel|badge-brother|couple-kid|fairly-easily|stop-haha|hyper-aware|collision-awareness|like-motorcycles|motorcycles-expensive|expensive-cars|cars-subarus|note-thank|cheap-emergency|emergency-jack
audi-tt|tt-quattro|longitudinal-acceleration|acceleration-sensor|sensor-g251|sensor-throw|code-like|gotthard-tunnel|tunnel-16|16-km|km-long|way),about-half|half-way|traction-control|control-light|light-come|vag-com|longitudinal-acceleration|acceleration-sensor|sensor-code|tunnel-happen|weird-eh|longitudinal-acceleration|acceleration-sensor|sensor-g251|longitudinal-acceleration|acceleration-sensor|sensor-g251|g251-implausible|implausible-signal
grand-plan|comfortable-bike|long-haul|cooler-bar|bar-hopper|hopper-custom|custom-bike|basic-maintenance|idea-tip|far-baconator|mini-road|road-king|upgrade-black|black-bag|bag-white|white-fender|fender-windshield|windshield-cruiser|cruiser-bar|large-tank|ideally-find|cool-decal|tank-pig|cop-uniform|uniform-bacon|bacon-strip|vintage-font|font-etc|etc-dirty|dirty-bobber|bobber-throw|sissy-bar|bar-springer|engine-rebuild|rear-fender|fender-matte|matte-black|ape-faux|faux-ironhead|ironhead-tear|tear-drop|drop-intake|intake-ape|ape-bobbed|bobbed-fender|fender-bare|bare-bone|brake-maybe|s-good|s-worth|end-rebuild|rebuild-come|good-time|local-dealership|unlimited-budget
fellow-porsche|porsche-enthusiasts|final-decision|wise-word|knowledgeable-porsche|porsche-people|daily-driver|follow-choice|year-old|old-cayman|cayman-s|-30k-km|-20k-mile|cheap-option|year-old|carrera-s|-50k-km|-30k-mile|expensive-option|year-old|-50k-km|-30k-mile|middle-price|price-wise|mention-concern|decision-factor|important-concern|concern-headroom|cm-tall|difficult-time|time-squeeze|local-dealership|head-touch|seat-leave|bit-disappointed|litre-turbodiesel|turbodiesel-skoda|base-model|zero-experience|automatic-transmission|drive-manual|automatic-car|cheap-rental|rental-car|old-automatic|automatic-system|appropriate-gear|gear-base|drive-style|bit-annoying|daily-driver|automatic-manual|manual-decision|important-decision|decision-factor|priority-order|long-time|time->|unforeseen-circumstance|maintenance-cost|money-time|fuel-consumption
total-mustang|v6-ti|ti-vct|vct-24v|24v-white|white-convertable|young-woman
320i-fully|fully-load|load-msrp|black-interior|grand-cherokee|cherokee-overland|year-lease|year-leave|red-320i|plus-like|like-3k|3k-down|like-red|black-fully|fully-load|year-lease|good-deal|dealership-right|manager-come|good-deal|mistake-needless|year-early|brand-new|new-320i|current-payment|year-lease|special-feel|smooth-car|bmw-habit|keep-want|upgrade-car|drop-80k
hey-guy|cool-look|v70r-tailgate|tailgate-spoiler|exact-color|pretty-pricey|generation-wagon
hi-guy|recently-buy|lexus-gs300|weird-idling|cold-start|little-bit|bit-low|temperature-gauge|drop-idle|car-vibrate|normal-operating|operating-temperature|guy-know|start-look|little-bit
bit-sporty|exterior-look|bit-boring|current-look|door-aspect|possibly-lower|rear-suspension|rise-compare|fairly-high
totally-new|3d-printing|mail-today|today-maylan|maylan-m200|try-heat|push-filament|little-drop|white-filament|filament-ooze|guitar-string|gently-poke|hot-end|end-inside|little-metal|metal-tube|tube-reach|hot-end|low-grub|grub-screw|oh-boy|try-pull|pla-break|original-blockage|blockage-d'oh|fitting-hex|hex-key|3d-printing|printing-experience|absolutely-necessary|start-explore|3d-printing|thing-come|extruder-break|replacement-lever|awsome-machine
minor-issue|cpo-warranty|og-warranty|warranty-exp|couple-week|week-ago|wind-noise|noise-come|left-shoulder|window-down|look-like|rear-driver|rubber-seal|normally-sit|sit-possibly|possibly-cause|cpo-warranty|customer-info|mention-minor|minor-wind|wind-noise|insignificant-seepage|clearly-look|look-like|window-alignment
mid-november|late-december|week-vacation|vacation-leave|car-outdoor|unknown-time|12v-battery|battery-crap|car-completely|completely-lose|emergency-key|tow-truck|car-run|run-fine|loud-noise|stop-abruptly|cold-snap|multiple-day|dealer-replace|battery-pack
look-like|red-brake|brake-light|light-bulbs|bulbs-online|fog-light|light-bulb|brake-light|fog-light
day-away|old-man|man-emu|emu-lift|lift-kit|terrible-luck|fuel-pump|pump-die|work-yesterday|rental-car|suspension-asap|f*cke-terrible|literally-avoid|avoid-offroade|headache-lol|lift-kit|good-replacement|replacement-stock|stock-suspension|ome-kit|greatly-appreciate
v40-sport|sport-estate|head-unit|cd-player|new-unit|hand-free|model-headunit|straight-swap
select-mini|mini-v2|3d-printer|sd-card|card-figure|test-model|print-perfect|auto-create|great-profile|profile-starting|starting-point|open-cura|file-menu|exist-gcode|gcode-file|produce-print|like-know|solid-starting|starting-point|rumor-magic|magic-number
market-value|value-past|past-present|gt3-rs|gt3-rs
long-time|sporty-honda|project-car|honda-tech|die-down|c-l|car-online
select-mini|mini-v2|cat-file|cura-set|current-version|current-version|print-thing|brand-new|thank-community
trip-screen|visit-family|+-mile|mile-trip|love-long|long-drive|trip-comfortably|usual-refueling|refueling-spot|cruise-control|control-set|73-mph|mph-118kph|ac-set|72f-22c|eco-mode|cruise-speed|hold-mode|ice-engine|good-mileage|pretty-stable|eastern-ma|planned-refueling|refueling-stint|cruise-speed|voltec-design|design-allow|atkinson-cycle|cycle-engine|efficient-range|+-mpg|3500-lb|lb-car|73-mph|ac-run|damn-good|couple-thing|ev-mileage|hold-mode|engine-recharge|little-bit|1000mi-trip|use-mountain|mountain-mode|maintain-acceleration|sacrifice-gas|gas-mileage|charge-hit|hit-zero|limp-mode|big-deal|hour-trip|fuel-door|bug-deflector|dead-bug|bug-splat|nearly-clean|keep-bug|highway-speed|magnetic-damper|ride-quality|road-trip|ride-quality|cabin-noise|noise-level|adjustment-option|trip-home|hvac-system|system-use|practice-run|temperature-drop|actually-enjoy|perfect-car|short-trip|ice-ev|ev-arrangement|arrangement-like|diesel-locomotive|great-configuration|long-trip|fuel-tank|little-big|voltec-drivetrain|fun-luxurious|luxurious-body|hidden-gem
hey-gent|look-like|great-shape|minor-problem|aesthetic-mod|black-headlight|rear-black|black-sequential|sequential-rear|rear-light|sinistre-look|guy-think|bullitt-owner
daughter-throw|throw-away|half-hour|hour-drive|drive-away|key-plus|plus-charge|small-fortune|car-down
recently-lease|s5-sportback|pre-sense|sense-failure|failure-warn|warn-long|long-story|a5-sportback|enjoy-drive|performance-luxury|luxury-type|type-car|actually-react|react-like|rocket-like|regular-traffic|feel-like|super-grabby|slow-down|super-slow|super-fast|happy-medium|regret-buy|fast-car
small-community|community-airport|completely-open|large-annual|annual-event|destination-charger|charger-program|single-response
nav-disc|clublexus-thread|people-mention|print-text|knockoff-nav|nav-disc
early-model|model-s60|typical-early|early-adopter|adopter-problem|new-polish|initial-build|wheel-drive|cold-weather|weather-package|s90d-soon|near-term|think-autopilot
different-standard|standard-color|additional-add|mobile-start|dealer-online|body-know|price-point|year-old|old-car
good-morning|look-like|120v-standard|prong-plug|zip-tie|long-lose|lose-block|block-heater|couple-thing|special-oil|oil-recommendation|routine-maintenence|maintenence-require
ceramic-break|month-ago|notice-sporadic|sporadic-squeaking|squeaking-come|squeaky-ceramic|ceramic-brake|brake-fluid|fluid-flush|major-maintenance|possible-new|new-brake|brake-fluid|fluid-reduce
size-truck|tow-regularly|extra-bed|bed-space|little-background|35-k|snow-etc|etc-.|access-quad|quad-cab|door-truck|reliability-long|long-term|term-drive|drive-quality|test-drive|follow-list|particular-order|different-truck|chevy-silverado|silverado-custom|v8-double|double-cab|.6l-v6|v6-quad|quad-cab|ford-f150|f150-xl|v6-ecoboost|ecoboost-super|super-cab|cab-obviously|ride-quality|steep-hill|hill-honestly|honestly-feel|ford-ecoboost|4-k|k-cheap|2-k|k-cheap
couple-week|week-ago|getting-run|thank-goodness|engine-light|simple-electrical|map-code|s-easy|old-dealer|tear-apart|valve-break|crank-seize|spark-plug|pretty-damn|damn-wild|simultaneously-enjoy|bike-carnage
speaker-size|premium-non|non-b&o|b&o-b9|b9-a4s|premium-package|speaker-size|size-online
originally-order|open-box|box-v2|power-supply|look-brand|brand-new|axis-control|different-surge|surge-protecter|wall-outlet|home-axis|bad-power|power-supply|firmware-issue|power-supply|12v-10a|10a-power|power-brick|second-time|wrong-version|version-printer|diy-kit
work-print|heater-wire|wire-reroute|look-like|heated-bed|long-hole|look-like|like-thermal|thermal-insulation|know-revision|people-advise|advise-new|new-owner|bed-reroute
check-engine|engine-light|vapor-cannister|cheap-reason|4runner-sport
remember-hear|hear-year|year-ago|automatic-transmission|drivetrain-loss|manual-transmission|new-automatic|automatic-like|dual-clutch|clutch-pdk|pdk-unit
past-monday|yesterday-evening|drive-home|clutch-click|bite-point|pedal-sound|sound-similar|somewhat-common|common-issue|good-wait|post-break|period-oil|oil-change|service-dept|recent-owner|owner-experience|sound-like|like-subaru|got-sort
short-trip|sport-mode|wheel-break|break-free|nice-little|little-squeal|squeal-continued|glance-down|sport-mode
blob-eye|eye-wagon|current-hang|need-new|new-rim|rim-tire|need-new|new-tire|size-wheel|wheel-people|size-tire
v6-manual|surprisingly-good|good-shape
4th-gen|sound-come|motor-sound|sound-spin|smog-pump|learn-toyota|toyota-instal|instal-smog|smog-pump|emission-level|toyota-simply|simply-add|pump-clean|clean-air|good-idea|repair-replace|smog-pump|stupid-expensive|real-problem|work-leave|work-overtime|fuck-toyota|smog-pump|pass-emission|emission-test|place-previously|emission-total|ramble-post|obligatory-picture|baby-affectionately|mother-fuccker
m-seek|seek-opinion|style-rack|custom-fabricate|basket-style|style-rack|rack-like|utility-rack|ideal-long|long-item|item-like|carry-paddle|paddle-boards|boards-kayak|kayak-surfboard|surfboard-snowboards|cargo-style|small-item|long-item|hybrid-design|basket-style|style-like|gobi-stealth|long-item|strong-way|removable-like|like-gobi|removable-crossbar|scaffold-style|style-t|t-clamps|tent-200lbs|200lbs-appreciate
stock-transmission|dealer-shop
new-trunk|.8-t.|opening-correctly|trunk-come|b5-4motion|emergency-trunk|trunk-release|latch-mechanism|old-trunk
y-o|narrow-down|mazda-cx-|heavily-lean|se-plus|wish-list|new-car|pretty-simple|simple-solid|solid-gas|gas-mileage|work-leather|leather-seat|seat-android|android-auto|smooth-drive|se-plus|great-cost|cost-efficient|efficient-option|se-plus|main-difference|se-plus|turbo-charge|charge-engine|fast-maybe|quick-pickup|work-route|route-usually|tucson-drive|feel-like|se-plus|great-price|offer-trade|se-plus|hyundai-website|expect-similar|similar-result|dealership-westchester|westchester-country|country-ny|ny-area|edit-sorry|ugly-uncapitalized|uncapitalized-title|reason-lol
dealership-mechanic|run-idol|degree-day|60degree-colorado|colorado-winter|winter-evening|clicking-sound|experienced-guy
want-xm|base-package|want-android|android-auto|android-auto|pretty-competitive|down-payment
ironhead-project|basket-case|start-mess|good-resource|battery-ignition|ignition-alternator|alternator-generator|generator-etc|etc-.|headache-down
accord-hybrid|year-love|electric-mode|slow-speed|musical-sound|sound-come|like-pull|red-light|light-people|window-open|window-open|windows-sound|sound-computerized|computerized-music|music-y.|electric-mode|essentially-silent|help-explain|hybrid-accord
long-story|story-short|fully-disclose|disclose-history|immediately-offer|civic-hybrid|civic-hybrid|civic-hybrid|bad-battery|bit-sluggish
limited-service|normal-connect|usual-message|minute-later|radio-turn
look-space|rattle-sound|sound-come|bit-concerned|test-drive
brand-new|new-genesis|genesis-g90|key-fob|fob-trunk|trunk-release|release-button|hand-release|actual-key|probably-got|got-skip|pdi-process|display-vehicle|upcoming-event
test-drive|jeep-community|modification-adventure|orv-park|week-ago
a4-b5|b5-avant|unfortunately-look|low-cost|trouble-find|audi-guru|guru-know|reasonable-asking|asking-price|decent-condition|small-chip|oil-screen|screen-5k|5k-mile|mile-ago|oil-sludge|sludge-problem|small-vacuum|vacuum-leak|leak-cause|idle-rough|run-fine
fiance-drive|proper-summer|summer-tire|experienced-driver|pretty-competitive|hailcorprate-shoutout|bf-goodrich|goodrich-sport|sport-comp2
tucson-eco|trailer-hitch|bike-rack|weigh-cost|install-hitch|rack-rail|current-owner|trunk-rack
drive-pilot|autonomous-drive|drive-feature|driver-attention|drive-pilot|pilot-work|help-ease|long-commute
hi-guy|rear-left|left-blinker|left-blinker|rear-light|extra-fast|fast-flasher|turn-signal|left-blinker|function-properly|function-fine|turn-signal|signal-work|research-trouble|trouble-shoot|shoot-tip|indicator-switch|switch-relay|left-rear|rear-light|light-assembly|try-change
cbv-post|feel-like|cbv-xc40|stall-indefinitely|paperwork-establish|liberty-mutual|completely-cancel|foreign-market|thing-tell
little-closable|closable-pocket|barely-big|fine-gentleman|effective-use
select-mini|3d-printer|basic-print|like-camera|camera-mount|mount-case|important-item

535i-oil|oil-level|level-sensor|confuse-manly
dumb-mistake|radio-panel
sound-like|loud-mouse|mouse-squeaking|vancouver-right|try-lift|try-spray|surround-area|about10-minute|try-lube
adapter-seal|oil-cooler|cooler-gasket|b7-a4|a4-quattro|.0-t.|enjoyable-pain|oil-pressure|pressure-light|air-bubble|oil-pump|extra-info|oil-change|change-no|no-later|5k-mile|2k-mile|oil-system|slow-leak
bike-relate|fucking-help|help-desk|res-user|color-format|r-harley|turn-night|night-mode|op-post|r-harley|turn-nightmode|huge-deal|subs-css|res-issue|issue-edit|edit-res|res-=|=-reddit|reddit-enhancement|enhancement-suite|suite-v5.10.3
skoda-roomster|tdi-engine|maintenance-schedule|water-pump|timing-build
