loaner--model--s|pretty--nice--broadcast|nice--broadcast--range|broadcast--range--similar|gate--open--outward
random--hard--reset
amg--c43--107k|c43--107k--mile|new--starter--motor|starter--motor--require|motor--require--grease
local--saab--specialty|saab--specialty--shop
high--pitch--whine|pitch--whine--come
tire--pretty--easily|lousy--austin--road
long--uphill--mountain|uphill--mountain--drive|volt--preform--spectacularly|adaptive--cruise--set|engage--mountain--mode|speed--limit--hit|old--v8--jeep|steady--smooth--rate|section--feel--like|feel--like--drive
model--come--stock|come--stock--like
long--distance--camping|distance--camping--vehicle|trailer--hitch--instal|buy--improve--shock|improve--shock--strut
oil--change--interval|+--km--pass|oil--change--interval|recommend--engine--flush|engine--flush--esp|modern--car--like

upper--low--ball|low--ball--joint|sway--bar--issue
upgrade--air--intake
rubber--connect--point|springy--metal--wire|metal--wire--thing|wire--thing--actually|thing--actually--end|rubber--attach--point|annoying--springy--metal|springy--metal--wire
issue--ac--cold|ac--cold--air|cold--air--stop|air--stop--blow|cold--air--completely|air--completely--stop|completely--stop--blow|pure--hot--air|try--new--freon|ac--heater--air|tell--ac--compressor|ac--compressor--need|compressor--need--replace|ac--control--unit|control--unit--break|plastic--knob--break|hot--air--gets|air--gets--blow|spend--extra--money|new--ac--control|ac--control--unit
fantastic--sub--today|sub--today--thing|year--ago--today|brilliant--new--way|cut--sale--cost
kit--scream--eagle|scream--eagle--intake|eagle--intake--vance|hines--exhaust--17|exhaust--17--k|17--k--mile|m--pretty--shure|smooth--running--engine|running--engine--right
weird--ticking--happen|canada--wide--thing|old--model--imo|entire--hyundai--experience

trd--pro--w/27k|pro--w/27k--mile
apple--carplay--apline|carplay--apline--radio|dash--stock--radio

satin--black--finish|black--finish--17x9|finish--17x9---12|17x9---12--mm|-12--mm--offset|6x5.5--bolt--pattern|greatly--appreciate--thank
svt--cobra--come|return--later--down
good--stealthy--charge|stealthy--charge--station|tesla--wall--charger
week--model--x|model--x--p100d|x--p100d--today|garage--door--opening|opening--pretty--hard|poor--model--x.
liter--v8--magnum|v8--magnum--quad|magnum--quad--cab|vin--number--run
38k--mile--luxury|mile--luxury--trim|pro--nav--heated|nav--heated--seat|deleted--badge--luxury|badge--luxury--trim
screamin--eagle--slip|s&s--air--cleaner|previous--owner--look|owner--look--online|s&s--super--e|super--e--setup|order--v&h--short|v&h--short--shot|different--air--cleaner
cosmetic--mod--jeep|toy--drive--maybe|m--getting--lift|housing--situation--change|trouble--witha--common|witha--common--parking|common--parking--garage|real--question--come|question--come--down
stock--equipment--bumper|budget--boost--instead
pretty--rough--shape|long--arm--kit|arm--kit--sit

pretty--good--idea|civic--si--coupe
leg--severely--bruise|foot--completely--crush|rib--leg--foot|leg--foot--hand
s3--27k--mile|130k--carmax--warranty
x--pipe--sound|stock--h--pipe|nice--classic--muscle|classic--muscle--sound
a5--s--line|s--line--manual|credit--card--debt|driver--window--regulator|fail--clutch--switch|blower--motor--work|upside--oil--consumption
air--vent--like|big--cross--section
auto--lane--change
good--choice--right|big--down--payment|mk6--gti--manual|mk6--gli--manual|gli--manual--preferably|hot--hatch--fever
severely--worn--right|worn--right--hand
volt--exclusively--outside|volt--handle--snow|handle--snow--ice
tool--arm--hand|arm--hand--positioning
actual--average--market|average--market--value|visit--community--classfie|community--classfie--website
market--air--intake
road--glide--ultra
additional--information--honda|information--honda--accord|year--old--36k|ac--engine--etc|engine--etc--.|etc--.--price

e350--rwd--sedan|-liter--direct--injection|direct--injection--gasoline|injection--gasoline--v-|lb--ft--torque|e400--rwd--sedan|-liter--biturbo--direct|biturbo--direct--injection|direct--injection--gasoline|injection--gasoline--v-|lb--ft--torque
rear--power--shade|aftermarket--reproduction--gear|non--mb--gear
pretty--straight--forward|straight--forward--look|slip--ons--bomber|ons--bomber--slash|bomber--slash--cut|header--powerflex--header
tdi--dmf--bail|dmf--bail--hard|sachs--kit--_url_
absolute--dream--job
bfg--ko2s--recently
alternator--gauge--dancing|gauge--dancing--esp|bad--voltage--regulator|new--test--fine|week--later--sit|alt--gauge--start|gauge--start--dance|car--die--like
high--mileage--cpo|like--interesting--timing|low--cost--model|cost--model--s|model--s--cpos|good--buy--right|previously--sell--use|sell--use--car|high--mileage--right|low--mileage--pre|mileage--pre--owned|totally--new--category|high--end--car|model--s--owner|buy--new--car|old--model--s|high--mileage--car|high--mileage--cpo|mileage--cpo--program|cpo--program--like
decent--cheap--car|major--expensive--repair|expensive--repair--like|repair--like--engine|like--engine--replacement
happy--saturday--boy|leave--car--wash|epc--light--come|semi--major--repair
sound--pretty--good

50--lb--german|lb--german--shepherd|german--shepherd--puppy|new--mustang--gts

melt--filament--underneath|tape--fiberglass--wrap
acura--rsx--type|axle--need--replace|previous--owner--tell
maybe--useful--upgrade|face--lift--version|know--bumper--headlamp|bumper--headlamp--rear|headlamp--rear--light|rear--light--cluster|new--wide--space|wide--space--boot|space--boot--lid|boot--lid--volvo|lid--volvo--logo
sr5--v6--2wd|v6--2wd--automatic|constant--adjustment--bad|adjustment--bad--mpg|bad--mpg--slow|mpg--slow--acceleration|average--leg--room|motorize--antenna--mechanism|great--styling--inside|2nd--gen--look|gen--look--great|look--great--build|great--build--quality|interior--surprisingly--good|fantastic--stock--exhaust|stock--exhaust--note|exhaust--note--good|note--good--visibility|electric--slide--tailgate|slide--tailgate--window|tailgate--window--comfortable|window--comfortable--seat|rear--cargo--area|cargo--area--trade|mediocre--2nd--row|2nd--row--legroom|excellent--ride--thank|great--stock--suspension|stock--suspension--tuning|stupid--good--resale|good--resale--value|somewhat--forget--toyota|forget--toyota--4runner|2nd--gen--4runner
merry--christmas--porsche|christmas--porsche--fan|40k--budget--maybe|budget--maybe--slightly
rear--passenger--window|passenger--window--recently|window--recently--drop|little--repair--kit|rear--window--regulator|broken--plastic--piece|likely--rarely--use
jeep--cherokee--sport|cherokee--sport--feel|sport--feel--like|micheal--bay--style|bay--style--explosion|pure--breed--prone|breed--prone--issue|crack--cylinder--head|cylinder--head--thank|vehicle--relatively--soon|small--boat--trailer|mid--small--size|small--size--range|-cylinder--4wd--obviously|4wd--obviously--reliability|obviously--reliability--probably|greatly--appreciate--thank
hey--guy--sadly|mazda3--base--model|base--model--manual|mazda3--sport--model|sport--model--automatic
11k--original--mile|spend--money--purchase|catback--accessport--airfilter|accessport--airfilter--possible|airfilter--possible--bov
passat--r--line|personal--finance--help
body--style--necessarily|3rd--party--advice
metal--connector--piece
pretty--big--jam|brass--piece--connect
carbon--engine--issue
long--time--reader
anticipate--appreciation--down
model--x--owner|x--owner--notice|drive--vs--actual|vs--actual--drive|actual--drive--mile
e200d--exclusive--luxury|ride--completely--ruin|want--amg--rim|4k--option--nearly
new--w204--wheel|look--incredibly--tired
long--story--short|local--junkyard--buy|long--life--span

school--resource--vehicle|local--school--officer
look--like--christmas|like--christmas--light
jeep--wrangl--sahara|unlock--map--error|dealer--website--ask
227--k--mile|k--mile--like|3rd--gear--shift|gear--shift--down|certain--throttle--position|drain--fill--method|light--throttle--input|high--throttle--position|transmission--fully--rebuild|60--k--mile|k--mile--ago|tow--hitch--instal|maybe--transmission--cooler|transmission--fluid--flush|bad--electrical--connection|tranny--engine--vehicle|engine--vehicle--combo
volt--dropping--like|non--econocar--depreciate
new--subaru--right|like--new--car|-door--low--price|particular--highway--mileage|nicer--drive--experience|crosstrek--increased--ride|increased--ride--height|like--sit--higher|plastic--body--cladding|include--x--mode|optimize--torque--distribution|low--speed--traction|hill--descent--control|-speed--manual--like|official--tow--rating|huge--bonus--point|edit--add--tow
time--subaru--owner|b4--gt(ej20--4at
new--headlight--assembly|jagged--line--like|line--like--8|like--8--ft|start--knock--stuff
permanent--fixture--plug|violate--fire--code|fire--code--right
model--s--version
jiffy--lube--conventional|lube--conventional--synthetic|conventional--synthetic--blend|straight--conventional--oil|straight--conventional--oil|synthetic--conventional--blend
car--overheat--recently|radiator--fan--resistor|notice--maxi--fuse|upside--down--like|down--like--metal|like--metal--portion|metal--portion--point|epic--practical--joke
bit--san--diego|san--diego--county|diego--county--represent|realize--recovery--point|diy--install--price|install--price--vs|price--vs--quality|vs--quality--etc|quality--etc--.


big--car--guy|km--definitely--low
crack--n--fade|find--someplace--capable
32--mb--card
sway--bar--spring
worth--consider--thank
center--console--box|large--circle--shape|circle--shape--mechanism
good--deal--down
vent--seat--switch|seat--switch--_url_|heating--seat--switch|seat--switch--_url_

impreza--rs2.5--manual|rs2.5--manual--tran|car--shake--loudly|new--viscous--coupling

.0--t--rhd|t--rhd--model|rhd--model--different|model--different--reservoir
8k--down--payment|exciting--like--vacation|hard--time--justify|time--justify--buy|good--run--jku
slight--gassy--smell|hour--shift--today
hellow--fellow--lexus|fellow--lexus--driver|small--green--light|cig--light--thing|green--light--turn
new--type--r|great--look--car|type--r--look|r--look--pretty|look--pretty--badass|turbos(type--r--wrx
capital--intensive--process|generate--lithium--ion|lithium--ion--cell|start--build--power|build--power--train|power--train--component|apple--buying--display
gto--grand--national|grand--national--chevelle|japanese--tuning--scene|local--car--coffee|1jz--swap--mk3|ungodly--exhaust--sound|exhaust--sound--single|sound--single--turbo|single--turbo--470whp|comb--club--lexus|club--lexus--supra|lexus--supra--forum|pretty--detailed--guide|clean--look--single|look--single--owner|single--owner--sc300|owner--sc300--auto|110k--mile--near|maybe--consider--sell|supposedly--decent--condition|main--concern--right|advice--suggestion--comment|suggestion--comment--concern


long--verify--carfax|verify--carfax--history|new--tire--oil|tire--oil--change|oil--change--valve|change--valve--cover|valve--cover--gasket|cover--gasket--time|gasket--time--belt|water--pump--cam|pump--cam--seal|cam--seal--spark|seal--spark--plug|spark--plug--k&n|plug--k&n--air|k&n--air--filter|lighting--package--sport|package--sport--package|leather--power--seat|reputable--audi--vw|audi--vw--shop
ford--focus--titanium|brand--new--mind|drive--home--mazda|home--mazda--grand|mazda--grand--touring|grand--touring--edition|touring--edition--hatchback|no--long--deal|constant--transmission--issue|repair--history--aside|decent--car--seat|car--seat--cover|seat--cover--suggestion|beige--tan--color|year--hopefully--year
new--paint--job|heat--cooled--seat|new--shitty--car
hi--recently--buy|service--soon--light|soon--light--blink|rough--idle--intermittently|ac--system--like|slight--vibration--compare|fan--.--nbsp|old--halogen--car|nbsp--tap--noise

honda--pilot--ex|pilot--ex--headunit|ex--headunit--infotainment|headunit--infotainment--screen|honda--pilot--ex|anti\-theft--radio--code|anti\-theft--radio--code
fairly--consistent--transmission|consistent--transmission--failure|mile--round--trip|student--loan--debt|truck--thing--target|thing--target--shooting|target--shooting--hunting|shooting--hunting--fishing|hunting--fishing--haul
insane--extended--warranty|extended--warranty--option|warranty--option--available|extended--coverage--warranty
x3--xdrive28i--suv|premium--sound--system|new--vehicle--especially|connect--phone--audio|equally--good--sound|good--sound--quality|radio--xm--usb|xm--usb--port|like--phone--manufacture|different--bluetooth--audio|bluetooth--audio--transmitter|water--non--existent|non--existent--bass|existent--bass--treble|bass--treble--etc|treble--etc--.|auxiliary--port--bluestream|sound--incredibly--low|incredibly--low--quality|low--quality--compare|static--type--sound|low--bass--treble|significantly--etc--.|aftermarket--sterio--replacement|sterio--replacement--option|long--post--haha
125--k--mile|109--k--mile|k--mile--onwards|brake--booster--cluster|booster--cluster--reflow|cluster--reflow--ignition|reflow--ignition--coil|ignition--coil--ignition|coil--ignition--lock|ignition--lock--new|lock--new--battery|new--battery--new|battery--new--starter|new--starter--new|starter--new--timing|new--timing--belt|timing--belt--water|belt--water--pump|tensioner--new--sway|new--sway--bar|rear--rear--stay|rear--stay--bar|stay--bar--new|bar--new--radiator|abs--sensor--regular|sensor--regular--oil|regular--oil--change|heater--score--good|transmission--fluid--change|introduce--new--tranny|new--tranny--fluid|tranny--fluid--slowly|slippery--slushy--day|slushy--day---once|reasonable--price--tag|price--tag--vs|angle--gear--check
old--vw--break|vw--break--down|guy--suggest--look
engine--temperature--sensor|temperature--sensor--think|check--engine--light
w203--panoramic--coupe|shade--got--stick|got--stick--open
long--story--short|engine--shut--down|internal--engine--work|sound--like--shit
squeal--non--stop|non--stop--like|special--snowflake--x|long--brake--breakin|brake--breakin--period|edit--sorry--mod
basic--car--like
hello--r--wrangler|sfw--sub--dedicate|redditor--share--pic|share--pic--video

flatbed--truck--come
small--square--like|square--like--130|like--130--mm|130--mm--160|mm--160--mm
blue--painter--tape|actual--cat--start|actual--filament--touch
new--car--i'm|car--i'm--interested|335i--coupe--x|coupe--x--drive|x--drive--m|drive--m--package|m--package--335i|package--335i--coupe|335i--coupe--x|coupe--x--drive|x--drive--maybe|drive--maybe--m|maybe--m--package|m--package--335i|package--335i--x|335i--x--drive|x--drive--m|drive--m--package|fun--daily--driver|daily--driver--maybe

story--start--monday|start--monday--morning|snow--pretty--heavy|silver--metal--expose|black--powder--coat|wheel--look--perfect|tl;dr--dealer--scratch|dealer--scratch--brand|scratch--brand--new|brand--new--wheel
civic--hatchback--soon|sale--literature--state|literature--state--premium|state--premium--fuel|sport--trim--look

hyundai--accent--saturn|accent--saturn--ls|saturn--ls--ford|ls--ford--focus
week--ago--_emoji_
-door--hatchback--veloster|hatchback--veloster--turbo|veloster--turbo--soon|fun--whip--handle|pretty--deadly--winter|drive--long--highway
reg--cab--xlt|basically--brand--new
maintain--100--km/h|long--tube--header|pretty--pretty--sure|battery--intake--swap|currently--run--near|run--near--stock|near--stock--tire
old--crappy--laptop
cheap--budget--laptop|budget--laptop--strictly|find--actual--gcode
kdss--pump--line|pump--line--etc|line--etc--.|loud--rattle--loose|rattle--loose--feel|end--dash--light|different--dealer--want|option--wise--reddit|regular--old--sway|old--sway--bar|sway--bar--link
rust--belt--brand|belt--brand--new|brand--new--vehicle|require--continuous--exposure
fuel--level--sensor|level--sensor--break|sensor--break--down|immobiliser--ignition--change|oil--level--rise|need--garage--intervention|garage--intervention--quick|intervention--quick--fix|brand--new--car

avg--fuel--consumption|fuel--consumption--drop
retrofit--old--volvo|old--volvo--alloy|new--model--like|c30--s40--v50|s40--v50--s60|v50--s60--s80|s60--s80--xc70|s80--xc70--v70|xc70--v70--model|cetus--centaurus--columbia|centaurus--columbia--tellus|new--alloy--fit|old--volvo--e.g.
steering--agility--etc|agility--etc--.
hardwiring--kit--need|center--console--outlet|hear--people--tap
wife--order--christmas|order--christmas--ornament|christmas--ornament--production|ornament--production--run|black--brown--goop|glass--bead--break|minimum--hassle--fast|hassle--fast--shipping|bit--price--conscious|monoprice--maker--select|maker--select--plus|thing--handle--overhang|handle--overhang--horribly|reprap--replacement--e3d|replacement--e3d--block|print--nylon--etc|nylon--etc--suggestion

experience--remove--store
premium--gt--roush
throttle--response--kinda|response--kinda--suck|tow--haul--mode|haul--mode--help
m--currently--buy|obviously--different--colour
collision--warn--false|warn--false--positive
base--stock--system|stock--system--suffice|upgrade--ability--aftermarket|ability--aftermarket--wise|aftermarket--wise--later

honda--accord--coupe|accord--coupe--ex|coupe--ex--4cyl|ex--4cyl--recently|power--steering--fluid|steering--fluid--flush|routine--oil--change|oil--change--brake|change--brake--tire|brake--tire--transmission|tire--transmission--fluid|transmission--fluid--drain|fluid--drain--refill|30k--brake--fluid|spark--plug--valve|plug--valve--adjustment
old--basket--case|run--down--junker|old--bike--like|new--wrencher--look|long--term--project|term--project--bike
_url_--right--rear|right--rear--lca|rear--lca--mount|vs--road--debris|road--guy--know

x5--35i--getting|35i--getting--rid|hard--time--find|time--find--information|wheel--panoramic--sunroof|panoramic--sunroof--surround|sunroof--surround--camera|surround--camera--nevada|camera--nevada--leather|nevada--leather--roof|leather--roof--rail|roof--rail--power|rail--power--tailgate|power--tailgate--paint|tailgate--paint--match|paint--match--fender|match--fender--trim|fender--trim--etc
audi--a4--fwd|a4--fwd--premium|fwd--premium--plus|.0--t--premium|t--premium--plus|premium--plus--technology|plus--technology--navigation|technology--navigation--bang|navigation--bang--olufsen|company--demo--vehicle
air--clean--box+snorkel|maf--sensor--disconnect|headlight--replacement--reinstall|traction--control--light|instrument--cluster--read|cluster--read--check|read--check--vsc|car--sit--overnight
engine--number--match|balance--shaft--issue|engine--light--come|entire--cabin--start|cabin--start--shake|free--code--scan|cryptic--intake--manifold|intake--manifold--code
diy--qi--charger|door--hand--pull
project--driver--volvo|fuel--pump--access|pump--access--hatch|access--hatch--allow
additional--fuse--box|metri--pack--connector|add--external--relay
lexus--toyota--vehicle
bulb--size--high|current--oem--headlight
blue--leather--seat|leather--seat--cover
know--traditional--advice|y--o--car|o--car--enthusiast|recently--pass--away|electronic--motor--tran|rear--end--minor|end--minor--damage
hey--r--honda|purchase--new--lower|new--lower--spring
dream--come--true|stereotypical--young--bmw|young--bmw--purchaser|baby--purr--like|check--engine--light
new--ecu--program|fellow--saab--enthusiast|tech--ii--experience
great--little--car|work--turn--signal|turn--signal--seatbelt|signal--seatbelt--alarm|seatbelt--alarm--etc|security--thing--issue

free--win--check|3l--na--v6|na--v6--single|v6--single--overhead|single--overhead--cam|overhead--cam--sohc|cam--sohc--18v|sohc--18v--automatic|open--engine--oil|engine--oil--cap|coolant--leak--mix|inside--look--like
near--dallas--tx|clutch--cover--left|cover--left--rear|left--rear--turn|rear--turn--signal|turn--signal--leave|turn--signal--master|signal--master--cyl|master--cyl--rebuild|cyl--rebuild--kit|rebuild--kit--caliper|kit--caliper--rebuild|caliper--rebuild--kit|rebuild--kit--battery|kit--battery--cover|battery--cover--forward|cover--forward--control|forward--control--clutch|control--clutch--lever|clutch--lever--clutch|lever--clutch--perch|clutch--perch--leave|perch--leave--mirror|engine--mount--bolt
time--belt--replacement|pay--blood--suck|blood--suck--moron|different--subaru--dealership|year--old--vehicle
continental--mobility--kit|volvo--roadside--assistance|closed--volvo--dealership|volvo--dealership--leave|reality--volvo--roadside|volvo--roadside--assistance|temporary--emergency--fix|tire--plug--kit|car--volvo--roadside|volvo--roadside--assistance
sport--plus--mode
pretty--small--potato|work--onstar--module|onstar--module--replacement|recall--turn--signal|finally--basic--googling
sup--peep--want|fuel--pressure--sensor
edit--sorry--misleading|sorry--misleading--title|misleading--title--look|title--look--like|f--mean--is-|f--sport--awd|headlight--etc--etc|etc--etc--.|etc--.--cheer
early--troubleshooting--thread|standard--operating--voltage|black--red--wire|open--printer--case|printer--case--handy|lcd--firmware--turn|red--wire--right|servo--forcibly--hold|find--similar--symptom|refresh--lcd--firmware|lcd--firmware--process|limit--switch--button|switch--button--hold|maybe--try--refresh|motion--controller--firmware|board--level--troubleshooting|level--troubleshooting--hint
120--mm--ground|mm--ground--clearance|usd--price--difference|stage--ii--apr
new--station--cuz|station--cuz--need|cuz--need--gas|new/--different--headlight
rear--bumper--slider|bumper--slider--roof|slider--roof--rack|roof--rack--icon|rack--icon--suspension
tax--dmv--bank|dmv--bank--fee|bank--fee--etc
slowly--lose--power|check--engine--light|p0341--camshaft--position|camshaft--position--sensor|circuit--range--performance|range--performance--bank|check--engine--light|camshaft--position--sensor|crankshaft--position--sensor|position--sensor--change|throttle--body--clean
dyna--street--bob
unknown--mod--dealer|alarm--button--prime|trunk--button--start|run--completely--remotely

model--s--click|service--center--close|long--way--tomorrow
intake--chamber--stay|chamber--stay--bracket|transmission--kickdown--throttle|kickdown--throttle--cable

+--hyundai--sonata|hyundai--sonata--sport
wrx--base--model|base--model--later|trash--maybe--moreso|package--door--speaker|door--speaker--tweeter|speaker--tweeter--subwoofer|gcs--apex--v2|apex--v2--android|v2--android--unit
interior--overhead--light|work--fine--include
car--second--mazda|good--quality--etc|huge--issue--obviously

good--case--scenario|new--heat--bed

feel--pretty--comfortable|pretty--comfortable--choose|p3--sport--edition|sport--edition--18x8|tire--wheel--tpm|blizzak--ws70--/50r18|oem--fanblade--wheels(sell|completely--new--set|order--code--64e.|code--64e.--edit|ford--service--center
hey--guy--wonder
buy--tow--printer|mini--select--v2s|select--v2s--wait|mini--delta--forum|4th--grade--classroom
boost--controller--intake
stock--summer--tire|mind--<--$|buy--aftermarket--wheel
day--photo--contest|dad--related--harley|related--harley--photo|bike--etc--.|biltwell--bantam--gloves|battery--tender--plus|tender--plus--charger|choice--2nd--place|submit--contest--entry
competition--look--like|fuel--efficiency--price|efficiency--price--point|price--point--~$50k|point--~$50k--+
.3--t--previous|t--previous--owner|previous--owner--pay|boost--gauge--fluttering|read--map--pressure|map--pressure--fast|wastegate--actuator--need|actuator--need--adjustment
like--old--truck|floor--shifter--constantly|shifter--constantly--jam
new--bike--come
cd--changer--keep|changer--keep--try|cd--changer--completely
tdi--jetta--home
small--oil--leak|rear--main--seal
couple--month--ago|gm--borla--exhaust|nice--happy--sound
intermittently--stall--start|stall--start--fine|start--fine--cold|check--engine--light|obd2--scanner--read|dashboard--light--warning|fuel--pump--relay
depth--buyer--guide
low--control--arm|inner--tie--rod
gt--hatch--manual|11mpg--new--tech
year--round--car
light--turn--green|start--turn--left|jeep--mechanic--look|brake--pedal--slightly
108--k--lie|lexus--gs--f|odd--reason--lexus|reason--lexus--decide|odd--way--lexus|way--lexus--fit|work--hard--vs|10--k--extra|extra--50hp--adjustable|50hp--adjustable--suspension

long--story--short|wrx--cvt--purchase|live--350--km|350--km--away|check--gas--cap|gas--cap--look
basically--brand--new|decently--new--jeep
softail--slim--black|slim--black--non|black--non--ab|chicago--land--area|good--otd--price
time--subaru--owner|brand--new--car|list--keep--grow|famous--subie--rumble
sound--intermittently--indicate|timing--chain--guide|chain--guide--tensioner|new--stuff--labor|compare--vw--want|perfectly--good--low|good--low--mileage|low--mileage--vin|mileage--vin--code|vin--code--matching|code--matching--replacement|matching--replacement--engine|125k--mileage--block|low--mileage--replacement|mileage--replacement--engine
standard--ford--sync|new--ford--sync|ford--sync--replace
angry--subaru--owner
vw--golf--mk6|seat--fully--forward|155--cm--tall|vw--golf--mk4|steering--wheel--length|thereabout--people--drive|people--drive--vw|drive--vw--golf
fuel--pressure--sensor|starter--relate--fuse
pass--nh--state|nh--state--inspection|fog--light--work|fall--apart--bulb|blank--plastic--plate|removed--fog--light|bumper--fog--light
good--mount--location|scosche--magnetic--mount
dedicated--navigation--button|connect--easy--fast|select--audio--media
phone--play--hardball|good--deal--cause

recently--purchase--eono|purchase--eono--ca8163r
change--body--panel
vanity--post--like|tesla--birthday--cake|actual--fruitful--discussion|weekly--experience--thread|good--interesting--discussion|interesting--discussion--disappear|deliver--tesla--model|tesla--model--s|model--s--model|s--model--add|chicago--car--clog|supercharger--new--tesla|new--tesla--service|tesla--service--center|service--center--picture|center--picture--jeremy|picture--jeremy--clarkson|jeremy--clarkson--comment|tesla--birthday--cake|birthday--cake--model|cake--model--x|restaurant--model--s|model--s--change|fremont--carpark--got|model--x--today|x--today--supercharger|today--supercharger--nearly|supercharger--nearly--online|model--x--taxi|x--taxi--discussion|revamp--model--s|model--s--today|lose--real--estate|nbsp--nbsp--note|weekly--q&a--thread|relatively--important--discussion
rabbit--hole--solar|install--soon--hopefully|northern--san--diego|san--diego--supercharger|place--clearly--design|near--available--charger|wait--list--program
tj--obligatory--picture|knob--stick--indicator|stick--indicator--light|indicator--light--result|strange--electronic--department|no--long--find|remote--ignition--setup|ignition--setup--start|quarter--turn--clockwise|preventative--maintenance--replace|maintenance--replace--fluid|replace--fluid--etcetera|rear--window--unzip
trailer--light--stop|light--stop--work|work--trailer--light|big--road--trip|cb--antenna--mount|trailer--light--stop|light--stop--work|tail--light--assembly|tail--light--assembly|tail--light--assembly|cb--antenna--mount|antenna--mount--bolt|quarter--panel--cut|sharp--edge--jeep|strategically--place--inside|cb--antenna--mount|antenna--mount--completely|big--road--trip|extremely--hot--day|trailer--light--inexplicably|light--inexplicably--stop|inexplicably--stop--work|stop--work--check|minute--delay--start
car--motorola--cpt9000|motorola--cpt9000--port|little--trouble--find|year--old--car
beautiful--fox--body|exact--fox--body|number--match--ford|match--ford--mustang|ford--mustang--gt|beam--connect--rod|port--e7--head|e7--head--edelbrock|multiple--clutch--cable|clutch--cable--clutch|cable--clutch--pressure|clutch--pressure--plate|pressure--plate--motor|plate--motor--mount

pretty--good--deal|include--detail--lifetime|detail--lifetime--drive|lifetime--drive--train
crdi--2wd--diesel|seemingly--random--moment|error--code--u0009|odb--ii--reader|additional--information--point|sudden--engine--stall|speed--gear--outside|brake--disk--cleaner|car--suddenly--regain|suddenly--regain--power|thick--black--smoke|black--smoke--come|fuel--filter--clean|glow--plug--functioning|cause--error--code|local--garage--find
low--ball--joint|ball--joint--replace|big--job--time|job--time--belt|time--belt--axle|belt--axle--seal|toyota--owners--website|open--safety--recalls|special--service--campaigns
hammock--style--rear|style--rear--seat|rear--seat--cover
motor--adjust--heating
think--standard--speaker|standard--speaker--wire

torque--converter--issue|fishing--hunt--vehicle|standard--lift--tire|nice--keep--forever|keep--forever--vehicle
mazda3--s--hatch|stoptech--drill--slot|drill--slot--rotor|potentially--dangerous--situation
honda--acura--fast|mod--like--new|like--new--wheel|new--wheel--suspension|wheel--suspension--maybe|panda--esque--scheme|white--paint--job|black--wheel--honda|wheel--honda--logo|honda--logo--etc|logo--etc--.
door--se--coupe|like--gm--saabs|aux--bt--adapter|bt--adapter--fine|low--mileage--saab|mileage--saab--like|amazing--reliable--car|probably--copy--paste
pilot--ex\-l--awd|pilot--tour--fwd|current--toyota--sienna|toyota--sienna--van|love--\(no--offense|wifi--connect--hard|connect--hard--drive|hard--drive--like|connected--thumb--drive|new--subaru--ascent
e46--bmw--m3|smg--pump--faulty|pump--faulty--rod|faulty--rod--bearing|/quarter--mile--time|good--tune--exhaust|tune--exhaust--intake|particular--budget--restriction
drive--new--car|new--car--recently|fairly--young--professional|good--steady--job
energizer--500w--power|500w--power--inverter|chevy--silverado--basically|red--fault--light|blue--normal--light|red--fault--light|12v--plug--replace
micro--sd--card|sd--card--change|ejection--yes--select|yes--select--eject|previously--save--desktop|save--desktop--folder|start--print--b|file--c--d
mishimoto--fan--lie|small--yellow--red|yellow--red--wire|yello--red--wire
.3l--version--upgrade
dynamic--cruise--control|bother--slow--down|car--start--accelerate|start--accelerate--right|completely--change--lane|auto--stop--start|stop--start--feature|unnecessary--specially--consider
gold--bbs--wheel|buy--rear--coilover

couple--post--similar|seriously--consider--purchase|new--model--x.|early--reservation--30|reservation--30--k|wife--dog--child|dog--child--trip|southern--new--hampshire|preferred--route--typically|city--typically--queens
240v--charge--station
online--researching--maybe|great--look--car|look--car--ride|car--ride--great|ride--great--look|great--look--like
local--home--depot|car--button--push|car--like--harry|like--harry--potter|secret--windshield--spot|trusty--service--center|zealous--cell--tower|wireless--security--system|security--system--sensor|readily--noticeable--antenna|noticeable--antenna--array|antenna--array--nearby|fob--stop--work|model--x--bluetooth|x--bluetooth--ish
3rd--gen--pretty|5th--gen--owner
cylinder--gasoline--engine
prusa--i3--mk3|mpselectmini--v2--wow|thing--look--sooo|look--sooo--nice|local--hardware--store|hardware--store--cut|template--add--layer|add--small--binder|small--binder--clip|reliable--bed--adhesion|bed--adhesion--no|adhesion--no--matter|dozen--fail--print

4runner--sr5--instantly
plastic--door--frame|door--frame--require|frame--require--roof|require--roof--frame|roof--frame--lock|frame--lock--clip|lock--clip--attach|jk--sport--2dr
number--lease--36mo/|000mi--hyundai--ioniq|hyundai--ioniq--limited|prius--value--generously|recently--test--drive|lexus--ct--200h

decent--truck--down|4x4--limited--natural|limited--natural--white|natural--white--4runner|truck--look--clean|valve--cover--leak|cover--leak--oil|need--new--tire|terrain--tire--handle|brand--new--toyo|new--toyo--at2s
fairly--low--mileage|look--pretty--clean|non--audi--dealership
long--story--short
non--turbo--mazda|completely--different--platform
15k--sport--car|sport--car--like|reliable--fun--daily|fun--daily--driver
wind--rain--deflector|pair--fit--normally|feel--wrong--bend|cross--year--compatibility
low--tire--pressure|tire--pressure--light|pressure--light--come
totally--understand--people
queen--print--fine|print--fine--despite|bed--leveling--issue|let--print--run|completely--structurally--useless|jammed--filament--melt|stale--pla--clog|pla--clog--nozzle|brand--new--roll
post--facelift--manual|bimmerforum--zhp--mafia|zhp--mafia--craigslist|mafia--craigslist--autotrader|craigslist--autotrader--cars.com
silverado--work--truck
test--drive--check|auto--repair--place|mb--bmw--volvo|bmw--volvo--etc|prev--owner--upgrade|223k--mile--ac|mile--ac--works|ac--works--antenna|retract--sun--roof|clean--check--vin|accident--report--seller|jack--location--head|location--head--number|head--number--hydraulic|number--hydraulic--rear|hydraulic--rear--suspension|rear--suspension--thanks
mustang--gt--s550|mgw--race--spec|gold--standard--solution|instead--incrementally--upgrade|incrementally--upgrade--different|improve--stock--shifter|stock--shifter--assembly|shifter--assembly--attachment|stock--trans--mount|trans--mount--steeda|mount--steeda--shifter|steeda--shifter--base|shifter--base--bushing|whiteline--positive--shift|positive--shift--transmission|shift--transmission--mount|transmission--mount--bushing|mount--bushing--insert|shifter--base--bushing|base--bushing--purchase|bushing--purchase--obsolete|budget--friendly--modification|bracket--bushing--upgrade|attach--stock--shifter|stock--shifter--assembly|tran--blowfish--shifter|blowfish--shifter--support|shifter--support--bracket|weird--middle--ground|tran--mount--solid|mount--solid--feeling|tran--attach--mgw|attach--mgw--shifter|mgw--shifter--mgw|shifter--mgw--race|mgw--race--spec|race--spec--short|spec--short--throw|short--throw--shifter|option--performance--improvement|cheap--option--bad|option--bad--bang|diminish--return--territory
different--car--previously|easy--fix--thx
white--wrx--limit|perrin--shifter--stop|buy--jdm--drl|jdm--drl--fog|drl--fog--light|fog--light--bezel|c--light--drl
car--_url_--sort|sedan--civic--si|low--mile--like
subaru--wrx--112k|wrx--112k--mile|112k--mile--stock|yrs--past--60k|past--60k--mile|growling--noise--feel|passenger--wheel--sound|wheel--sound--like|slight--bump--like|10k--mile--leave|mile--leave--brake|rear--wheel--bearing|10k--mile--ago|colder--weather--come|maybe--tie--rod|thank--r--subaru|help--edit--update|cv--joint--issue|makeshift--tool--update|change--ball--bearing|ball--bearing--reduce|inspect--cv--find
c350--coupe--currently|cost--effective--option
new--mb--a180d|describe--android--auto

volt--automatically--pair|pair--phone--list
_url_--_url_--_url_|_url_--_url_--_url_|trash--bin--junk|stuff--like--old|like--old--ford|old--ford--rangers|ford--rangers--f-150s|rangers--f-150s--exploders|f-150s--exploders--etc|exploders--etc--.|single--previous--owner|crazy--low--mile|weathertech--floor--mat|original--asking--price|alignment--wheel--balance|radio--steering--wheel|steering--wheel--button|delaminate--replace--radio|stupid--air--suspension
speedometer--problem--begin
sale--agent--try|perfect--fit--ready|old--car--right
club--style--bobber|spring--carb--exhaust|t--bar--like|bar--like--lucky|like--lucky--dave
sport--package--manual|package--manual--mile
cheap--etc--?

stop--short--guy|short--guy--problem|h--d--world
ignition--brake--lock|strange--whir--noise|whir--noise--come
spare--tire--compartment|u--haul--sell
support--video--format|000kbps--bitrate--720x576|bitrate--720x576--resolution|high--trim--level|certain--trim--package|convenience--package--instal|reprogram--hack--enable|hack--enable--video
print--warp--issue|warp--issue--today|buy--glass--cut|2--mm--spacer|glass--2--mm|try--safety--razor|safety--razor--blade|razor--blade--spatula

car--survive--multiple|survive--multiple--year|car--gets--total|cpo--car--available|sale--guy--tell|tad--bit--slow|low--mileage--oil|mileage--oil--change|hit--18k--mile|buy--extended--coverage|sale--guy--tell|cover--brake--pad|purchase--extended--warranty|original--warranty--end|cpo--warranty--end|exactly--35k--otd|exterior--color--mineral|color--mineral--grey|mineral--grey--metallic|grey--metallic--interior|metallic--interior--leather|interior--leather--black|leather--black--red|black--red--highlight|red--highlight--stitching|highlight--stitching--odometer|stitching--odometer--25k|odometer--25k--rwd|25k--rwd--sport|rwd--sport--line|sport--line--premium|line--premium--package|premium--package--technology|package--technology--package|technology--package--co2|package--co2--relevant|co2--relevant--vehicle|relevant--vehicle--sport|vehicle--sport--automatic|sport--automatic--transmission|automatic--transmission--tire|transmission--tire--pressure|tire--pressure--monitor|pressure--monitor--alarm|monitor--alarm--system|alarm--system--universal|system--universal--garage|universal--garage--door|garage--door--opener|door--opener--moonroof|lines--designation--moonroof|designation--moonroof--floor|moonroof--floor--mat|floor--mat--auto|mat--auto--dim|auto--dim--mirror|dim--mirror--auto|mirror--auto--dim|auto--dim--rearview|dim--rearview--mirror|rearview--mirror--power|seat--split--fold|split--fold--down|fold--down--rear|down--rear--seat|rear--seat--storage|seat--storage--package|storage--package--heated|seat--anthracite--wood|anthracite--wood--trim|wood--trim--highlight|trim--highlight--trim|highlight--trim--finisher|trim--finisher--pearl|finisher--pearl--blow|heater--park--distance|park--distance--control|distance--control--rain|control--rain--sensor|auto--headlight--xenon|headlight--xenon--headlight|xenon--headlight--adaptive|headlight--adaptive--light|adaptive--light--control|light--control--automatic|control--automatic--climate|automatic--climate--control|climate--control--ambient|control--ambient--lighting|ambient--lighting--additional|-v--power--socket|power--socket--harman|socket--harman--kardon|harman--kardon--surround|kardon--surround--sound|surround--sound--dvd|sound--dvd--area|dvd--area--code|area--code--na|code--na--bmw|na--bmw--teleservices|bmw--teleservices--teleservice|teleservices--teleservice--control|teleservice--control--cic|control--cic--contribution|cic--contribution--m|contribution--m--sport|m--sport--suspension|sport--suspension--increase|speed--limiter--variable|limiter--variable--light|variable--light--decode|light--decode--teleservice|decode--teleservice--activation|teleservice--activation--oil|activation--oil--chg|oil--chg--15k|chg--15k--miles/|15k--miles/--month|miles/--month--daytime|month--daytime--drive|daytime--drive--light

great--deal--close|android--auto--interface|midrange--android--device|android--device--moto|device--moto--phone|head--unit--function|unit--function--perfectly|run--android--nougat
inch--spacer--lift|gearing--braking--sye|minor--rock--crawl
recent--year--generally
car--rough--idle|error--code--come|good--cleaning--look
designo--selenite--grey|selenite--grey--magno|grey--magno--color|hear--mixed--opinion
welp--got--instal
parking--brake--button|parking--brake--light|car--automatically--disengage

k&n--performance--air|performance--air--intake|power--commander--v|dyna--superglide--custom|surely--keep--add|keep--add--piece|scream--eagle--ii|eagle--ii--pipe
gear--speed--rpms


walk--away--enable
genuinely--feel--like|stock--clutch--feel|steeda--assist--spring
rainy--climate--keep
drive--pretty--conservatively|real--power--mod|reccomend--spring--strut|coilover--etc--.
good--search--term|search--term--etc|stock--fiberglass--shell
stupid--bright--ambulance|bright--ambulance--tail|ambulance--tail--light
hard--time--hone|gt--vs--v6|vs--v6--gt|v6--gt--sound|gt--sound--amazing|bloat--price--far|base--gt--simply|keep--cost--down|manual--vs--standard|big--congested--town|congested--town--houston|close--family--member|family--member--suggest|member--suggest--automatic|offcentered--stripe--esp|white--white--platinum|white--platinum--car|v6--convertable--manual
print--large--thing|raspberry--pi--case|print--today--_url_|bed--warm--running
porsche--panamera--model|panamera--model--year|beautiful--sport--steering|sport--steering--wheel|alcantara--nice--exhaust|nice--steering--wheel|pretty--steering--wheel|steering--wheel--later
a4--w--t|w--t--quattro
high--pitch--whine
new--malyan--m200|printer--lay--down
axle--o2--sensor|current--gen--civic|gen--civic--ex|civic--ex--t
m3--gt--hatchback|tie--down--hook
mile--white--a4|white--a4--premium|long--life--span
overall--rebuild--mod|rear--wheel--wheel|wheel--wheel--cut|new--section--weld|fairly--thorough--craigslist|thorough--craigslist--hunt|aero--w/130k--mile|owner--dealer--maintain|lip--rear--spoiler|wash--clay--bar|clay--bar--wax|bar--wax--trim|wax--trim--interior|trim--interior--engine
allen--head--bolt|actual--exhaust--stud|near--chopper--shop|chopper--shop--straight|work--welding--place
illusion--audio--fit|stock--corner--dash|corner--dash--location|dash--location--crutchfield|location--crutchfield--website|speaker--diameter--mount|diameter--mount--depth|mount--depth--require
nice--daily--driver|suv--sorta--thing|carry--gym--equipment|gym--equipment--regularly
new--truck--shell|small--hatch--style|hatch--style--door|style--door--embed|kinda--like--doorception|literal--interior--door|interior--door--hinge|factory--hinge--remain|inset--_url_--apology|yeti--like--arm|like--arm--cheer
fairly--spongy--print|spongy--print--lately|little--extrusion--knock|solid--smooth--surface|high--temp--insulation|temp--insulation--like
aftermarket--head--unit|possibly--android--car|original--unit--specifically
day--round--trip|gas--milage--come
little--thing--annoy|huge--untouched--spot|glove--box--middle|box--middle--seat
325xi--accident--free

artificial--limitation--impose|nice--round--number|round--number--regardless
owner--southern--vehicle|taxis--title--etc|title--etc--.|4th--gen--recently|dealer--counter--offer
rock--chip--paint
upgrade--hp--fuel|hp--fuel--pump|fuel--pump--cat|turbo--bypass--valve|bypass--valve--coil|valve--coil--pack|coil--pack--low|pack--low--temp|low--temp--spark|temp--spark--plug|spark--plug--drill|plug--drill--slot|drill--slot--rotor|slot--rotor--b|rotor--b--c|high--flow--cat|timing--belt--clutch|belt--clutch--chain|rattle--new--motor|new--motor--mount|motor--mount--change|diff--fluid--oil|fluid--oil--change|basic--maintenance--item|drive--able--tune|cold--new--england|new--england--winter
toyota--tundra--stock|tundra--stock--wheel|factory--fender--flare|pretty--danged--wide
recommend--tire--brake|occasional--track--day|think--excellent--sight|excellent--sight--line
map--acceleration--performance|battery--charge--level|battery--charge--decline|battery--size--selfishly|model--s--p90dl
different--d&d--mini|d&d--mini--model
recently--start--look|porsche--certify--pre|upgrade--sport--chrono|sport--chrono--bose|chrono--bose--bi|bose--bi--xenon|bi--xenon--etc
chrome--trim--underneath
stock--bmw--18inch|bmw--18inch--run|18inch--run--flat|dealer--recommend--new|recommend--new--tire|non--run--flat
civic--116--k|code--p1457--evap|p1457--evap--system|evap--system--leak|system--leak--detect|leak--detect--canister|detect--canister--area|canister--area--p0133|area--p0133--ho2s-|circuit--slow--response|gas--tank--shut|charcoal--canister--area
service--manual--instruction|manual--instruction--park|parking--brake--apply|brake--apply--shift|normal--driving--temperature|t--iv--atf
little--plastic--catch|center--console--arm|console--arm--rest|arm--rest--down|rest--down--snap|arm--rest--lid|new--center--console|mind--find--wholesalehyundaiparts.com
run--v55--firmware|dealer--certify--pre|android--auto--tweak
stock--mini--ape|luckydaves--sandiego--bars|female--harness--plug
heat--block--wire|temperature--sensor--wire|actually--melt--apart|thing--temperature--sensor|slave--heat--bed|heat--bed--power|bed--power--supply|protect--power--strip
month--ago--completely|ago--completely--stock|stage--mod--intake|mod--intake--cleaner|intake--cleaner--exhaust|v&h--big--radius|good--performance--compatibility
highlight--autopilot--work|reduce--driver--fatigue|m--b--b250e|short--straight--stretch|enable--android--auto|android--auto--carplay|sort--indicate--failure|long--road--trip|ice--free--soon
mp--select--mini|select--mini--v2|nozzle--touch--down|touch--down--twice|thing--a.--attempt|buildtak--b.--repeatedly|b.--repeatedly--ram|provide--hex--tool|printer--try--multiple|try--multiple--different|multiple--different--print|different--print--attempt|print--attempt--print|microsd--clean--nozzle|filament--return--printer|wifi--gcode--ensure|nice--hatchbox--stuff|borosilicate--glass--bed|glass--bed--soon
battery--light--turn|check--engine--light
drive--home--today|investigate--oil--temperature|fuel--pressure--problem|fuel--filter--fuel|filter--fuel--pump
year--old--window|old--window--weatherstripping|allow--easy--access
big--truck--splatter|truck--splatter--ton|gas--smell--smoke

little--extra--step|cheap--plastic--stool
5th--gen--4runner|find--solid--year
drive--mediocre--car|year--finally--bite|jeep--yj--especially|sexy--smoke--tail|smoke--tail--light|turbo--tuesday--guy|tuesday--guy--n|guy--n--gal

hey--r--lexus|f--sport--package|receive--decent--snowfall|pay--sub--40k|help--r--lexus
buy--mazda--itoure|popular--package--today|configure--car--setting|schedule--maintenance--oil|maintenance--oil--change|tire--rotation--question|12v--power--outlet
service--oil--change|oil--change--break|change--break--bowden|break--bowden--cable|bowden--cable--amp;amp;amp|cable--amp;amp;amp--bracket|late--model--ruby|model--ruby--red|ruby--red--infinity|red--infinity--q60|half--bad--right|razor--sharp--handling|sharp--handling--intimate|handling--intimate--road|intimate--road--feel|tight--leather--glove|thick--wool--mitten|no--long--dominate|instead--gingerly--navigate|gingerly--navigate--like|olympic--speedskater--intently|speedskater--intently--cross|seemingly--linear--power|linear--power--available|millennium--falcon--blasting|catapult--forward--usually|momentary--pass--opportunity|nav--system--backup|system--backup--camera
time--car--buyer
astronomical--high--tide|high--tide--associate|east--coast--flood|saltwater--flood--car
radiator--look--normal|blow--warm--air
early--version--circa|pcs--starting--fully|starting--fully--brake
pristine--look--mercedes|look--mercedes--benz|mercedes--benz--c63|benz--c63--amg|brand--new--tire|new--tire--summer|low--18k--mile
daytime--running--light
oil--filter--housing|filter--housing--leak

pretty--strange--happen|digital--gauge--reflect|fuel--light--flash|fuel--senser--float
want--keyless--entry|remote--start--option|r--s--system
centerlock--wheel--yay|nose--lift--yay
100k--maintenance--loom|local--dealer--want
milk--crate--hold
premier--fully--load|lane--departure--warning|slightly--low--ev|low--ev--range|hint--thought--insight


mirror--adjustment--switch
online--auction--site
triple--yellow--ecoboost|ecoboost--performance--package
instrument--cluster--light|turn--signal--light|signal--light--flash|start--rip--stuff|rip--stuff--apart
rust--belt--cali|belt--cali--texas|cali--texas--etc|hear--story--and/or|story--and/or--advice|pre--purchase--question|find--particularly--helpful|particularly--helpful--assumption
northern--california--surface|brake--light--foam|light--foam--gasket|foam--gasket--degrade|gasket--unlimited--info|pretty--sneaky--leak|sneaky--leak--check|tailgate--carpet--etc|carpet--etc--.|etc--.--forewarn|f--sport--porn
-wheel--drive--blink|drive--blink--start|moderately--reputable--garage|new--electric--motor
share--drivetrain--loss|regen--conversion--loss|use--d--l|hotly--contest--issue
openlock--dungeon--tile|print--time--down
premium--compact--car|compact--car--chevrolet|car--chevrolet--volt|fuel--efficiency--improve|efficiency--improve--electric|improve--electric--range|new--chevrolet--volt|electric--car--segment|overall--range--stylish|range--stylish--exterior|dread--range--anxiety
f--sport--exhaust|sport--exhaust--installation|exhaust--installation--tutorial
low--mileage--sub|mileage--sub--70k|sub--70k--535i|70k--535i--xdrive|535i--xdrive--wagon|bmw--import--thesis|import--thesis--beast|error--prone--mechanic|prone--mechanic--bait|second--friendly--german
keep--mouse--away

need--new--cable
subaru--club--think|harley--davidson--fandom|forester--xt--blow|tire--shred--right|end--pretty--bad|like--motorcycles--expensive|motorcycles--expensive--cars|expensive--cars--subarus|cheap--emergency--jack
audi--tt--quattro|longitudinal--acceleration--sensor|acceleration--sensor--g251|gotthard--tunnel--16|tunnel--16--km|16--km--long|way),about--half--way|traction--control--light|control--light--come|longitudinal--acceleration--sensor|acceleration--sensor--code|longitudinal--acceleration--sensor|acceleration--sensor--g251|longitudinal--acceleration--sensor|acceleration--sensor--g251|sensor--g251--implausible|g251--implausible--signal
cooler--bar--hopper|bar--hopper--custom|hopper--custom--bike|mini--road--king|upgrade--black--bag|black--bag--white|bag--white--fender|white--fender--windshield|fender--windshield--cruiser|windshield--cruiser--bar|cop--uniform--bacon|uniform--bacon--strip|vintage--font--etc|font--etc--dirty|etc--dirty--bobber|dirty--bobber--throw|sissy--bar--springer|rear--fender--matte|fender--matte--black|ape--faux--ironhead|faux--ironhead--tear|ironhead--tear--drop|tear--drop--intake|drop--intake--ape|intake--ape--bobbed|ape--bobbed--fender|bobbed--fender--bare|fender--bare--bone|end--rebuild--come
fellow--porsche--enthusiasts|knowledgeable--porsche--people|year--old--cayman|old--cayman--s|middle--price--wise|important--concern--headroom|difficult--time--squeeze|litre--turbodiesel--skoda|cheap--rental--car|old--automatic--system|appropriate--gear--base|automatic--manual--decision|important--decision--factor|long--time-->
v6--ti--vct|ti--vct--24v|vct--24v--white|24v--white--convertable
320i--fully--load|fully--load--msrp|grand--cherokee--overland|plus--like--3k|like--3k--down|black--fully--load|brand--new--320i
v70r--tailgate--spoiler
little--bit--low|normal--operating--temperature

mail--today--maylan|today--maylan--m200|white--filament--ooze|hot--end--inside|little--metal--tube|metal--tube--reach|low--grub--screw|original--blockage--d'oh|fitting--hex--key|3d--printing--experience
og--warranty--exp|couple--week--ago|wind--noise--come|normally--sit--possibly|sit--possibly--cause|mention--minor--wind|minor--wind--noise|clearly--look--like
week--vacation--leave|12v--battery--crap|car--completely--lose|car--run--fine
red--brake--light|brake--light--bulbs|light--bulbs--online|fog--light--bulb
old--man--emu|man--emu--lift|emu--lift--kit|fuel--pump--die|literally--avoid--offroade|good--replacement--stock|replacement--stock--suspension
v40--sport--estate
select--mini--v2|sd--card--figure|great--profile--starting|profile--starting--point|exist--gcode--file|solid--starting--point|rumor--magic--number
market--value--past|value--past--present

select--mini--v2
+--mile--trip|love--long--drive|usual--refueling--spot|cruise--control--set|73--mph--118kph|planned--refueling--stint|voltec--design--allow|atkinson--cycle--engine|3500--lb--car|use--mountain--mode|sacrifice--gas--mileage|charge--hit--zero|cabin--noise--level|hvac--system--use|ice--ev--arrangement|ev--arrangement--like|fun--luxurious--body
rear--black--sequential|black--sequential--rear|sequential--rear--light
daughter--throw--away|half--hour--drive|hour--drive--away|key--plus--charge
pre--sense--failure|sense--failure--warn|failure--warn--long|warn--long--story|performance--luxury--type|luxury--type--car|actually--react--like
small--community--airport|large--annual--event|destination--charger--program
knockoff--nav--disc
early--model--s60|typical--early--adopter|early--adopter--problem|cold--weather--package
different--standard--color|year--old--car
long--lose--block|lose--block--heater|special--oil--recommendation|routine--maintenence--require
notice--sporadic--squeaking|sporadic--squeaking--come|squeaky--ceramic--brake|brake--fluid--flush|possible--new--brake|new--brake--fluid|brake--fluid--reduce
extra--bed--space|snow--etc--.|access--quad--cab|reliability--long--term|long--term--drive|term--drive--quality|chevy--silverado--custom|v8--double--cab|.6l--v6--quad|v6--quad--cab|ford--f150--xl|v6--ecoboost--super|ecoboost--super--cab|super--cab--obviously|steep--hill--honestly|hill--honestly--feel|4--k--cheap|2--k--cheap
couple--week--ago|pretty--damn--wild
premium--non--b&o|non--b&o--b9|b&o--b9--a4s|speaker--size--online
open--box--v2|look--brand--new|different--surge--protecter|bad--power--supply|12v--10a--power|10a--power--brick|wrong--version--printer
heater--wire--reroute|look--like--thermal|like--thermal--insulation|people--advise--new|advise--new--owner
check--engine--light
remember--hear--year|hear--year--ago|new--automatic--like|dual--clutch--pdk|clutch--pdk--unit
pedal--sound--similar|somewhat--common--issue|period--oil--change|recent--owner--experience|sound--like--subaru
wheel--break--free|nice--little--squeal|little--squeal--continued
blob--eye--wagon|need--new--rim|new--rim--tire|need--new--tire|size--wheel--people
surprisingly--good--shape
motor--sound--spin|learn--toyota--instal|toyota--instal--smog|instal--smog--pump|toyota--simply--add|pump--clean--air|pass--emission--test
m--seek--opinion|basket--style--rack|style--rack--like|ideal--long--item|long--item--like|carry--paddle--boards|paddle--boards--kayak|boards--kayak--surfboard|kayak--surfboard--snowboards|basket--style--like|removable--like--gobi|scaffold--style--t|style--t--clamps|tent--200lbs--appreciate

emergency--trunk--release
pretty--simple--solid|simple--solid--gas|solid--gas--mileage|work--leather--seat|leather--seat--android|seat--android--auto|great--cost--efficient|cost--efficient--option|turbo--charge--engine|work--route--usually|expect--similar--result|dealership--westchester--country|westchester--country--ny|country--ny--area|ugly--uncapitalized--title
60degree--colorado--winter|colorado--winter--evening
want--android--auto
battery--ignition--alternator|ignition--alternator--generator|alternator--generator--etc|generator--etc--.
musical--sound--come|red--light--people|windows--sound--computerized|sound--computerized--music|computerized--music--y.
long--story--short|fully--disclose--history

rattle--sound--come
brand--new--genesis|new--genesis--g90|key--fob--trunk|fob--trunk--release|trunk--release--button|probably--got--skip

a4--b5--avant|audi--guru--know|reasonable--asking--price|oil--screen--5k|screen--5k--mile|5k--mile--ago|oil--sludge--problem|small--vacuum--leak|vacuum--leak--cause
proper--summer--tire|bf--goodrich--sport|goodrich--sport--comp2

autonomous--drive--feature|drive--pilot--work
rear--left--blinker|extra--fast--flasher|turn--signal--work|research--trouble--shoot|trouble--shoot--tip|indicator--switch--relay|left--rear--light|rear--light--assembly

little--closable--pocket
like--camera--mount|camera--mount--case

535i--oil--level|oil--level--sensor

loud--mouse--squeaking
oil--cooler--gasket|b7--a4--quattro|oil--pressure--light|oil--change--no|change--no--later
fucking--help--desk|turn--night--mode|res--issue--edit|issue--edit--res|edit--res--=|res--=--reddit|=--reddit--enhancement|reddit--enhancement--suite|enhancement--suite--v5.10.3

