broadcast-range|hand-clicker|hand-clicker|loaner-model|nice-broadcast|broadcast-range|range-similar|hand-clicker|gate-open|mean-come|broadcasting-watt|save-power
random-hard|hard-reset
mechanic-instal|new-starter|starter-motor|starter-motor|motor-require|require-grease|new-mechanic
coolant-leak|water-pump|specialty-shop|new-pump|junkyard-car|similar-issue|good-place
morning-hear|high-pitch|pitch-whine|whine-come|engine-look|revs-drive
alignment-issue|rubber-mallet|grease-suffice
road-trip|long-uphill|uphill-mountain|mountain-drive|good-feedback|mileage-number|adaptive-cruise|cruise-set|engage-mountain|mountain-mode|battery-leave|speed-limit|limit-hit|shift-gear|optimum-power|maintain-speed|keep-climb|steady-smooth|smooth-rate|cruise-keep|proper-speed|section-feel|bit-nervous|mountain-grade|previous-post
end-sit|inch-close|model-come|come-stock|previous-owner|lower-spring
daily-driver|long-distance|distance-camping|camping-vehicle|trailer-hitch|hitch-instal|rear-suspension|buy-improve|improve-shock|shock-strut|daily-driving
wife-drive|oil-change|oil-change|change-interval|synthetic-oil|oil-change|change-interval|engine-flush|oil-change|recommend-engine|engine-flush|modern-car
high-quote|mind-tell
state-inspection|place-state|upper-low|low-ball|ball-joint|rejection-sticker|ball-joint|sway-bar|bar-issue|ball-joint|pass-inspection
exhaust-system|good-rumble|upgrade-air|air-intake
road-king|rubber-connect|connect-point|springy-metal|metal-wire|wire-thing|rubber-attach|attach-point|annoying-springy|springy-metal|metal-wire
past-experience|simple-fix|cold-air|air-stop|stop-blow|cold-air|stop-blow|pure-hot|hot-air|try-new|new-freon|engine-heat|need-replace|unit-break|plastic-knob|knob-break|hot-air|spend-extra|extra-money|replace-repaired|try-freon|control-unit|long-time|knowledge-advice|wonderful-day
fantastic-sub|sub-today|today-thing|brilliant-new|new-way|cut-sale|sale-cost|sell-vehicle|repair-garage|electric-vehicle|repair-shop|sell-vehicle|honest-question
scream-eagle|eagle-intake|k-mile|fucking-haul|run-great|highway-speed|run-great|smooth-running|running-engine|engine-right
engine-repair|weird-ticking|ticking-happen|important-issue|dealership-today|small-town|model-car|exact-problem|massive-recall|keep-tell|avoid-drive|bit-worried|main-issue|massive-problem|massive-problem|similar-gripe|wide-thing|corporate-level|old-model
70k-mile|airbag-replace|receive-notice|faulty-airbag|humid-condition
w/27k-mile|great-price|terrible-decision
apple-carplay|install-radio|long-time|wiring-harness|dash-stock|stock-radio|great-thank
headlight-flash|grocery-store|viper-system|flash-green|positive-jingle|flash-red|caution-sound
canadian-dealer|different-finish|-12-mm|mm-offset|bolt-pattern|appreciate-thank
big-fan|special-place|heart-lol|high-school
electric-vehicle|good-stealthy|stealthy-charge|charge-station|tesla-wall|wall-charger|experience-build
test-drive|p100d-today|test-drive|owner-advisor|activate-summon|garage-door|door-opening|car-keep|huge-sigh
liter-v8|v8-magnum|magnum-quad|quad-cab|size-bed|transfer-case|vin-number|number-run|transfer-case|4lo-indicator
independent-inspection|38k-mile|soft-suspension|great-price|pro-nav|nav-heated|heated-seat|e60-530i|usual-check|wear-component|rac-inspection|deleted-badge|badge-luxury|luxury-trim|twin-exhaust
eagle-slip|air-cleaner|previous-owner|owner-look|short-shot|exhaust-play|different-air|air-cleaner|mechanical-background|carburet-setup
cosmetic-mod|mod-jeep|toy-drive|tire-size|housing-situation|situation-change|trouble-witha|witha-common|common-parking|parking-garage|lift-pay|real-question|question-come|run-37|jeep-height
previous-post|coil-lift|stock-equipment|equipment-bumper|stock-equipment|budget-boost
diff-cover|stock-open|limited-slip|rough-shape|long-arm|arm-kit|kit-sit|fucker-snap|worth-throw|super-d35
v8-swap|find-kit|strong-internal|add-power
good-idea|drive-stick|car-payment|suspension-mod|force-induction
change-lane|insurance-company|medical-bill|issue-come|rib-leg|leg-foot|foot-hand|insurance-company|right-equipment|ride-boot|leather-boot
27k-mile|good-price|-30k-mile|tune-switch|bad-idea
x-pipe|muscle-car|x-pipe|pipe-sound|muscle-car|muscle-car|deep-sound|violent-sound|nice-classic|classic-muscle|muscle-sound
line-manual|60k-mile|credit-card|card-debt|decent-job|car-inspect|motor-mount|driver-window|window-regulator|fail-clutch|clutch-switch|cruise-control|washer-fluid|blower-motor|motor-work|differential-mount|upside-oil|oil-consumption|great-shape|japanese-car|time-bomb
new-feature|air-vent|new-vent|lot-quieter|big-cross|cross-section|vent-hole|guy-think
test-drive|auto-lane|lane-change|mom-tend
brother-buy|good-choice|big-down|down-payment|poor-formatting|hot-hatch|hatch-fever
clunk-sound|poor-road|suspension-relate|worn-right|right-hand|engine-mount|oil-pan
positive-feedback|additional-question|handle-snow|snow-ice|keep-track|little-cautious|big-decision
trouble-remove|mount-bolt|brake-line|proper-flush|original-starter|mechanic-yoga|tool-arm|arm-hand|hand-positioning|diesel-thing|tight-space|good-advice
frequent-reader|actual-average|average-market|market-value|thought-lead|price-guide|market-price|visit-community|community-classfie|classfie-website|price-range|mean-value|excel-number
look-perfect|market-air|air-intake|special-tune|help-haha
new-rgu|ride-today|flat-tire|tow-company|friend-hang|fortunate-bless|great-group
additional-information|year-old|old-36k|year-warranty|look-amazing
car-model|particular-interested

rear-power|power-shade|aftermarket-reproduction|reproduction-gear|non-mb|mb-gear|terrible-quality|c-class
bomber-slash|slash-cut|header-powerflex|powerflex-header|catalytic-converter|deep-rumble|big-sucker|format-issue
flywheel-conversion|safe-bet
new-store|absolute-dream|dream-job|guy-enjoy|sell-come|people-force|people-end|general-experience
tire-size|feel-free|ask-question
alternator-gauge|gauge-dancing|bad-voltage|voltage-regulator|new-test|test-fine|alt-gauge|gauge-start|start-dance|car-die|fuel-gauge|fuel-pump|has.any-idea
high-mileage|interesting-timing|low-cost|good-buy|sell-use|use-car|high-mileage|mileage-right|low-mileage|mileage-pre|pre-owned|new-category|extra-revenue|major-pivot|extra-service|increase-fleet|refurbish-work|good-way|increase-workforce|assume-sale|help-boost|quarter-end|delivery-target|new-car|increase-revenue|smooth-ramp|scale-production|help-alleviate|spend-~$35k|fast-way|boost-revenue|production-ramp|primary-motivation|premium-car|p100d-loaner|high-end|end-car|buy-new|new-car|large-influx|high-mileage|mileage-car|time-come|high-mileage
decent-cheap|cheap-car|low-price|major-expensive|expensive-repair|engine-replacement|summer-think|round-trip|look-good
leave-car|car-wash|epc-light|light-come|turn-engine|semi-major|major-repair

good-deal|keep-look
lb-german|german-shepherd|shepherd-puppy|sporty-car
quick-question|4wd-vehicle|late-summer|engage-4wd|fact-engaging
long-print|night-print|start-print|actual-project|heating-element|melt-filament|tape-fiberglass|fiberglass-wrap|cable-tube|un-fixable
super-sweet|speed-sit|mom-neglect|major-issue|start-restore|main-question|rsx-type|axle-need|need-replace|tie-rod|ball-joint|previous-owner|owner-tell|tl;dr-try
proud-owner|mint-condition|useful-upgrade|face-lift|lift-version|car-mirror|minor-touch|know-bumper|bumper-headlamp|headlamp-rear|rear-light|light-cluster|new-wide|wide-space|space-boot|boot-lid
3rd-car|automatic-vehicle|idle-speed|constant-adjustment|adjustment-bad|bad-mpg|mpg-slow|slow-acceleration|average-leg|leg-room|2nd-row|motorize-antenna|antenna-mechanism|need-replace|plastic-tooth|thing-lol|definite-positive|great-styling|2nd-gen|gen-look|look-great|great-build|build-quality|road-capability|smooth-v6|fantastic-stock|stock-exhaust|exhaust-note|note-good|good-visibility|electric-slide|slide-tailgate|tailgate-window|window-comfortable|comfortable-seat|rear-cargo|cargo-area|area-trade|mediocre-2nd|2nd-row|row-legroom|excellent-ride|ride-thank|great-stock|stock-suspension|suspension-tuning|stupid-good|good-resale|resale-value
begin-look|40k-budget|price-range|early-model|exact-model|new-model
rear-passenger|passenger-window|cold-day|little-repair|repair-kit|repair-video|regulator-remove|rear-window|window-regulator|broken-plastic|plastic-piece|avoid-buy|rivet-gun
style-explosion|pure-breed|breed-prone|prone-issue|crack-cylinder|cylinder-head|head-thank|friendship-end|mechanic-ability|big-job|haul-power|small-boat|boat-trailer|truck-include|mid-small|small-size|size-range|appreciate-thank
trouble-decide|base-model|model-manual|sport-model|model-automatic|big-issue|cruise-control|cost-~$|new-car|cruise-control
11k-original|original-mile|guy-read|rebuilt-title|spend-money|money-purchase|catback-accessport|accessport-airfilter|airfilter-possible
r-line|local-dealer|great-deal|month-lease|new-job|new-a3|sound-dismissive|personal-finance|finance-help
long-time|big-priority|-120k-mile|financial-situation|12k-upfront|5th-gen|body-style|3rd-party|party-advice|long-post
bowden-tube|jam-today|metal-connector|tube-break|3d-printable|metal-connector|connector-piece|extruder-motor
3d-printer|big-jam|brass-piece|piece-connect|bowden-tube|filament-jam|brass-piece|try-heat
little-bit|ring-issue|engine-issue|snow-tire|carbon-engine|engine-issue
time-poster|long-time|time-reader|pre-approve|car-purchase
high-mileage|clean-example|50k-mile|end-depreciation|anticipate-appreciation
owner-notice|large-discrepency|battery-state|available-mile|actual-drive|drive-mile|battery-life
no-no|steel-spring|20-multispoke|luxury-look|air-suspension
total-misuse|fresh-look
long-story|story-short|local-junkyard|junkyard-buy|work-good|amp1-break|long-life|life-span
owner-today|good-wave|subreddit-bud|poop-day|obligatory-picture|bad-quality
school-resource|resource-vehicle|local-school|school-officer

jeep-wrangl|unlock-map|map-error|sirius-sub|update-firmware|dealer-website|website-ask|sd-card|navi-package
mile-like|3rd-gear|gear-shift|4th-overdrive|certain-throttle|throttle-position|drain-fill|fill-method|light-throttle|throttle-input|high-throttle|throttle-position|certain-speed|k-mile|transmission-intercooler|interesting-consider|tow-hitch|hitch-instal|transmission-cooler|transmission-fluid|fluid-flush|solenoid-responsible|transmission-pathway|bad-electrical|electrical-connection|transmission-problem|tranny-engine|engine-vehicle|great-option|repair-shop
bit-shocking|model-change|non-econocar|econocar-depreciate
new-car|distinct-difference|impreza-hatchback|certain-situation|miss-thing|low-price|fuel-economy|particular-highway|highway-mileage|interior-material|personal-preference|drive-experience|manual-transmission|increased-ride|ride-height|road-capability|plastic-body|body-cladding|interior-material|personal-preference|road-capability|include-x|x-mode|optimize-torque|torque-distribution|low-speed|speed-traction|similar-stuff|manual-transmission|big-deal|extra-gear|official-tow|tow-rating|unrelated-reason|torque-y|huge-bonus|bonus-point|add-tow
shift-high|drop-rpm|vacuum-line|intake-sensor|similar-issue
new-headlight|headlight-assembly|look-stellar|drive-home|jagged-line|look-normal|shame-dollar|start-knock|knock-stuff|lawsuit-kidding
different-apartment|place-tell|wall-socket|cost-money|extension-cord|permanent-fixture|fixture-plug|upto-code|current-place|explain-time|ul-list|portable-device|violate-fire|fire-code|code-right|good-way|keep-approach|m-sad
guy-know|web-development|ice-car
oil-change|old-oil|conventional-synthetic|synthetic-blend|cheap-option|straight-conventional|conventional-oil|straight-conventional|conventional-oil|synthetic-conventional|conventional-blend|conventional-oil
cool-fan|car-overheat|hot-weather|radiator-fan|fan-resistor|engine-bay|metal-portion|portion-point|sound-insane|car-check|fuse-location|fan-run|epic-practical|practical-joke|possible-thing
start-drive|realize-recovery|recovery-point|good-place|diy-install|install-price|wheel-solo
long-term
little-backstory|daily-basis|new-wrx|let-hear|guy-drive
big-car|car-guy|forseeable-issue
console-insert|street-glide|crack-n|n-fade|shop-thst|find-someplace|someplace-capable
local-work|mb-card
little-help|sway-bar|bar-spring|good-route|nice-ride|rally-ready|rally-drive|good-place|guy-know|good-deal
market-leave|down-engine|try-search|honest-opinion|worth-consider|consider-thank
center-console|console-box|large-circle|circle-shape|shape-mechanism|loose-end
correct-place|current-car|good-deal|small-detail|guy-come|main-perk|price-difference|throw-money
wiring-diagram|vent-seat|seat-switch|right-direction|main-question|heating-seat|seat-switch|vents?(heating-switch|alot-cheap
hard-bag|hold-shut|bungee-cord
manual-tran|shake-happen|parking-space|sharp-corner|car-shake|hear-people|torque-bind|new-viscous|viscous-coupling
extension-cable|battery-compartment
model-different|different-reservoir|try-turn
new-jeep|home-mortgage|down-payment|hard-time|time-justify|justify-buy|income-class|good-run|run-jku
guy-glad|oil-change|tranny-fluid|slight-gassy|gassy-smell|general-service|tranny-fluid|deliver-package|hour-shift|hour-shift|shift-today|dealer-tomorrow
hellow-fellow|fellow-lexus|lexus-driver|small-green|green-light|cig-light|light-thing|green-light|light-turn
new-type|type-r|look-deadly|great-look|look-car|new-touring|buy-early|speed-junky|r-look|s-true|low-40
capital-intensive|intensive-process|begin-work|add-fuel|short-position|car-company|electric-vehicle|generate-lithium|lithium-ion|ion-cell|cell-supplier|future-market|start-build|build-power|power-train|train-component|car-company|buying-display
current-thread|knowledge-advice|mechanical-knowledge|old-day|engine-building|japanese-tuning|tuning-scene|project-car|local-car|car-coffee|swap-mk3|exhaust-sound|sound-single|single-turbo|recommend-stick|know-forum|recent-thread|organize-thing|-400hp-range|detailed-guide|clean-look|look-single|single-owner|solid-plan|consider-sell|engine-tran|decent-condition|car-manual|main-concern|wiring-harness|advice-suggestion|decent-background|thought-process|advice-suggestion|suggestion-comment|comment-concern
gas-engine
buy-gas|co-host|podcast-relate|historical-detail
long-verify|verify-carfax|carfax-history|new-tire|tire-oil|oil-change|change-valve|valve-cover|cover-gasket|gasket-time|time-belt|water-pump|pump-cam|cam-seal|seal-spark|spark-plug|air-filter|lighting-package|package-sport|sport-package|leather-power|power-seat|great-deal|good-care
constant-repair|brand-new|new-mind|edition-hatchback|25k-mile|constant-transmission|transmission-issue|new-owner|repair-history|normal-stuff|decent-car|car-seat|seat-cover|cover-suggestion|audio-equipment|drive-client|clean-clothing|door-panel|sound-distribution|small-sub
old-car|add-oil|smug-test|traction-control|computer-trouble|new-paint|paint-job|heat-cooled|cooled-seat|worth-repair|new-shitty|shitty-car
smooth-quieter|light-blink|rough-idle|fan-turn|slight-vibration|vibration-compare|absolute-quiet|roughness-come|accessory-cycling|head-light|old-halogen|halogen-car|tap-noise|cruise-speed
bad-price|experience-drive
headunit-infotainment|infotainment-screen|anti\-theft-radio|radio-code|anti\-theft-radio|radio-code|new-headunit|anti\-theft-code
consistent-transmission|transmission-failure|ask-price|mile-round|round-trip|thing-hold|accountant-sister|student-loan|loan-debt|insurance-company|truck-thing|thing-target|target-shooting|shooting-hunting|hunting-fishing|fishing-haul
low-mileage|good-deal|luxury-car|agent-tell|insane-extended|extended-warranty|warranty-option|option-available|normal-limited|extended-coverage|coverage-warranty|include-expendable
premium-sound|sound-system|mind-boggle|new-vehicle|connect-phone|phone-audio|owner-address|auxillary-cord|good-sound|sound-quality|play-thing|radio-xm|xm-usb|usb-port|new-phone|auxiliary-port|irritating-issue|phone-manufacture|audio-transmitter|sound-terrible|static-sound|water-non|non-existent|existent-bass|bass-treble|remain-connect|center-console|power-outlet|auxiliary-port|low-quality|quality-compare|static-type|type-sound|low-bass|bass-treble|quality-volume|equalizer-option|like-consideration|aftermarket-sterio|sterio-replacement|replacement-option|sound-quality|long-post|post-haha
brake-booster|reflow-ignition|ignition-coil|battery-new|new-starter|starter-new|new-timing|timing-belt|belt-water|water-pump|sway-bar|stay-bar|bar-new|new-radiator|c-recharge|wheel-bearing|ball-joint|abs-sensor|sensor-regular|regular-oil|oil-change|conventional-oil|ignition-lock|previous-owner|long-list|heater-score|score-good|transmission-fluid|fluid-change|introduce-new|new-tranny|tranny-fluid|drain-fill|transmission-problem|good-base|glove-test|issue-arise|visual-inspection|glove-test|wheel-spin|slippery-slushy|slushy-day|day--once|stop-position|stop-position|cargo-space|safety-feature|reasonable-price|price-tag|angle-gear|gear-check
title-state|college-student|price-range|common-problem|price-range|edit-thank
radiator-fan|engine-temperature|temperature-sensor|sensor-think|radiator-fan|check-engine|engine-light
panoramic-coupe|previous-owner|shade-work|stick-open
time-poster|engine-open|initial-diagnosis|throw-rod|spun-bearing|long-story|story-short|gasket-blow|free-way|engine-shut|internal-engine|engine-work|throw-rod|spun-bearing|shop-close|new-engine
second-time|brake-burn|special-snowflake|long-brake|brake-breakin|breakin-period|bacon-reader|cell-phone|help-appreciate|home-computer
heated-seat|heated-seat|basic-car|seat-heater
new-sub|sfw-sub|sub-dedicate|redditor-share|share-pic|pic-video
proper-picture|guy-think
flatbed-truck|truck-come|tow-hook|tow-hook|tire-inflator|volt-premier
small-square|little-room|bed-clip|rectangle-glass
exact-process|blue-painter|painter-tape|light-layer|glue-stick|finish-printing|actual-cat|cat-start|printing-speed|actual-filament|filament-touch|stay-stick|filament-platform|little-spot|wrong-type|right-type
new-car|car-i'm|i'm-interested|drive-m|m-package|fun-daily|daily-driver|guy-think
engine-roar|electric-range|2nd-charge
story-start|brand-new|tech-tell|new-wheel|mount-wheel|bad-idea|outside-lip|silver-metal|metal-expose|black-powder|powder-coat|huge-gash|black-filler|filler-touch|paint-dry|wheel-look|look-perfect|know-wheel|new-wheel|picture-album|tl;dr-dealer|dealer-scratch|scratch-brand|brand-new|new-wheel
civic-hatchback|sale-literature|literature-state|state-premium|premium-fuel|hard-requirement|casual-driver|sport-trim|trim-look
quality-reliability|luxury-suv|sporting-quality
test-drive|vent-blower|jet-engine|fit-vent|common-issue
brake-light|past-couple|state-inspection|remember-buy|bright-bulb|different-bulb|bright-bulb
winter-driving|fun-whip|whip-handle|snowy-condition|deadly-winter|drive-long|long-highway
pavement-tell|transfer-case|brand-new
power-horse|quarter-tank|3rd-gear|new-exhaust|long-tube|tube-header|money-time|electric-fan|battery-intake|intake-swap|stock-tire
old-crappy|crappy-laptop
dedicated-laptop|cheap-budget|budget-laptop|slicing-software|main-machine|macbook-pro|find-actual|actual-gcode|sd-card
dream-truck|test-drive|dealer-claim|pump-line|loud-rattle|rattle-loose|loose-feel|end-dash|dash-light|different-dealer|dealer-want|option-wise|wise-reddit|regular-old|old-sway|sway-bar|bar-link|knowledgeable-tech
rust-belt|belt-brand|brand-new|shit-box|year-max|use-brine|brand-new|new-vehicle|irreparable-damage|time-assume|salt-touch|truck-start|require-continuous|continuous-exposure
fuel-level|level-sensor|sensor-break|immobiliser-ignition|ignition-change|computer-restart|random-occasion|oil-level|level-rise|need-garage|garage-intervention|intervention-quick|quick-fix|bit-excessive|brand-new|new-car
n54-engine
sound-nice|avg-fuel|fuel-consumption|consumption-drop|big-improvement|tank-avg
retrofit-old|new-model|alloy-wheel|new-alloy|alloy-fit
limited-version|regret-purchase|road-noise|steering-agility
dash-cam|parking-mode|hardwiring-kit|kit-need|accessory-source|help-decide|center-console|console-outlet|hear-people|people-tap|power-door|fuse-box
wife-order|ornament-production|production-run|thermister-bite|thermal-runaway|white-smoke|black-brown|brown-goop|glass-bead|bead-break|minimum-hassle|hassle-fast|fast-shipping|bit-price|price-conscious|monoprice-maker|maker-select|thing-handle|handle-overhang|help-fit|new-hotend|reprap-replacement|replacement-e3d|e3d-block|sock-replacement|upper-end|print-nylon
today-trade|common-thing|big-bike|reliability-factor
experience-remove|remove-store|big-concern|good-solution|viable-option
50k-mile|good-price|plan-add
new-f150|throttle-response|fuel-economy|throttle-response|throttle-response|mode-help
colosseum-gray|look-great|google-image|different-colour|major-dealership|different-colour
collision-warn|warn-false|false-positive|red-obstacle
heated-seat|worth-upgrade|base-stock|stock-system|system-suffice|upgrade-ability|ability-aftermarket|thank-guy
repair-cost|41k-mile|15k-yr|problem-repair|personal-experience
oil-change|power-steering|steering-fluid|fluid-flush|routine-oil|oil-change|change-brake|brake-tire|tire-transmission|transmission-fluid|fluid-drain|drain-refill|30k-brake|brake-fluid|spark-plug|plug-valve|valve-adjustment|timing-chain|water-pump|preventative-maintenance
i've-read|old-basket|basket-case|colder-month|old-bike|new-wrencher|wrencher-look|long-term|term-project|project-bike
road-debris|road-guy|guy-know|road-shop|drive-fine|rip-metal|start-crack
unknown-reason|sound-come|car-speaker
new-car|price-difference|hard-time|time-find|find-information|trim-level|wheel-panoramic|panoramic-sunroof|sunroof-surround|surround-camera|leather-roof|roof-rail|rail-power|power-tailgate|tailgate-paint|paint-match|match-fender|fender-trim
company-demo|list-price|company-demo|demo-vehicle|reputable-dealership|attach-sticker
involve-unclippe|maf-sensor|air-clean|clean-box+snorkel|warn-light|sensor-disconnect|replacement-reinstall|bulb-work|traction-control|control-light|instrument-cluster|cluster-read|read-check|warning-persist|couple-cycle|car-sit
87k-mile|engine-number|number-match|balance-shaft|shaft-issue|engine-light|light-come|entire-cabin|cabin-start|start-shake|free-code|cryptic-intake|intake-manifold|manifold-code|cylinder-misfire|code-reader|couple-time|cylinder-fix|incoming-disaster|little-concerned|horror-story
center-console|wireless-charger|storage-console|console-lid|yesterday-realize|door-hand|hand-pull|door-panel
project-driver|fuel-pump|pump-access|access-hatch|hatch-allow|faulty-pump
additional-fuse|fuse-box|factory-wiring|screw-terminal|money-time|negative-bus|add-external|external-relay
play-music|iphone-bell
anzo-headlight|honda-accord|bulb-size|size-high
blue-leather|leather-seat|seat-cover|seat-cover|love-input
know-traditional|traditional-advice|flood-car|o-car|car-enthusiast|air-cool|project-car|good-way|flood-911s|electronic-motor|motor-tran|rear-end|end-minor|minor-damage|flood-car
lower-spring|conflict-information|shock-absorber|purchase-new|new-lower|lower-spring|50k-mile
entire-life|dream-come|come-true|month-predate|purchase-learn|stereotypical-young|prized-possession|live-learn|live-paycheck|car-justice|lose-time|dream-car|engine-maintenance|strong-suspicion|need-replace|baby-purr|check-engine|engine-light|passionate-community
start-blue|month-fix|ignition-pathway|new-ecu|ecu-program|usual-way|factory-program|bricked-car|non-trivial|ecu-flashing|patience-confidence
great-little|little-car|great-price|work-turn|turn-signal|signal-seatbelt|seatbelt-alarm|actual-radio|new-radio|security-thing|thing-issue|aftermarket-radio|help-possible|aftermarket-radio
title-suggest|led-lowbeam|metal-adapter
father-buy|165k-mile|bad-idea|luxury-car|free-win|win-check|single-overhead|overhead-cam|open-engine|engine-oil|oil-cap|coolant-leak|leak-mix|car-inspect|run-good|weird-smell|inside-look|history-report
clutch-cover|cover-left|left-rear|rear-turn|turn-signal|signal-leave|turn-signal|cyl-rebuild|rebuild-kit|rebuild-kit|kit-battery|battery-cover|lever-clutch|clutch-perch|perch-leave|leave-mirror|engine-mount|mount-bolt|seat-solution|split-seat|low-priority
88k-mile|head-gasket|time-belt|belt-replacement|pay-blood|blood-suck|suck-moron|recommend-pay|extreme-regret|brand-new|year-old|old-vehicle|hit-disappointment
new-s60|advanced-version|parking-lot|air-escape|puncture-spot|tow-truck|phone-inform|dealership-leave|business-hour|mobility-kit|mobility-kit|fix-sealer|temporary-emergency|emergency-fix|tire-place|stuff-clean|tire-repair|stuff-affect|tire-plug|plug-kit|mobility-kit|tire-sealer|roadside-assistance
car-sit|pdk-revs|normal-mode|standard-maintenance|post-pic
small-potato|grand-scheme|work-onstar|onstar-module|module-replacement|recall-turn|turn-signal|fixable-issue|title-information|particular-song|hilarious-abbreviation|issue-happen|try-refresh|finger-pointing|issue-specific|basic-googling|technology-operate
peep-want|similar-issue|turn-lose|electrical-power|electrical-function
edit-sorry|sorry-misleading|misleading-title|title-look|difference-year|prospective-buyer
early-troubleshooting|troubleshooting-thread|standard-operating|operating-voltage|black-red|red-wire|open-printer|printer-case|case-handy|firmware-turn|early-problem|shining-moment|multimeter-probe|red-wire|current-setting|dead-short|backlit-screen|bed-push|find-similar|similar-symptom|refresh-lcd|lcd-firmware|firmware-process|limit-switch|switch-button|button-hold|try-refresh|motion-controller|controller-firmware|stupid-mistake|measure-current|meter-set|board-level|level-troubleshooting|troubleshooting-hint|red-black
ground-clearance|usd-price|price-difference|285ps-approx|plan-mention|350ps-approx
new-station|need-gas|mention-premium|sweet-premium|fellow-redditor|new/-different|different-headlight
new-4runner|trim-package|common-upgrade|rear-bumper|bumper-slider|slider-roof|roof-rack|rack-icon|icon-suspension|slight-lift|road-premium|trim-package|thank-guy
good-deal|bank-fee
need-help|low-rpm|little-gas|low-rpm|lose-power|check-engine|engine-light|p0341-camshaft|camshaft-position|position-sensor|circuit-range|range-performance|performance-bank|single-sensor|check-engine|engine-light|camshaft-position|position-sensor|crankshaft-position|position-sensor|sensor-change|bad-clean|throttle-body|body-clean|little-hand|right-direction
great-shape|great-deal|silly-question
day-come|unknown-mod|mod-dealer|discover-today|remote-start|aftermarket-remote|alarm-button|button-prime|glow-plug|trunk-button|button-start|bit-finicky|electrical-issue
fun-try|infotainment-screen|second-page
charge-port|service-center|center-close|long-way|way-tomorrow|click-noise
intake-chamber|chamber-stay|stay-bracket|intake-manifold|transmission-kickdown|kickdown-throttle|throttle-cable|fuel-line|size-bolt
little-cover|hour-search|cargo-cover
sonata-sport|tech-package|price-differ|car-gurus|bank-lady|good-deal|internet-price
base-model|stock-speaker|package-door|door-speaker|speaker-tweeter|tweeter-subwoofer|complement-eachother|stock-speaker|aftermarket-speaker|inline-amplifier
wrangl-sport|engine-start|interior-light|interior-overhead|overhead-light|turn-signal|high-beam|windshield-wiper|work-fine|fine-include
car-second|second-mazda|small-scratch|seat-cover|accommodate-airbag|size-fit|justify-cover|brand-fit|good-quality|huge-issue|spend-thousand
dirt-road|street-tire|look-cool
permanent-modification|faulty-thermistor|heat-block|bed-thermistor|thing-bad|good-case|case-scenario|work-v1|thermistor-replacement|fine-print|new-heat|heat-bed
seat-cover|leatherette-seat|sweaty-body|neoprene-cover
winter-tire|upcoming-winter|comfortable-choose|cheap-set|tire-wheel|wheel-tpm|selection-process|feel-confident|compatible-option|fanblade-wheels(sell|choose-tire|prevent-rubbing|brake-line|slight-variation|set-work|cost-benefit|new-set|thank-edit|stock-wheel|buy-new|order-code|service-center
guy-wonder|plastic-valance|radiator-look|approach-angle
3d-printing|print-lot|process-work|buy-tow|tow-printer|v2s-wait|4th-grade|grade-classroom
subaru-life|downpipe-exhaust|logical-step|boost-controller|controller-intake
stock-rim|swap-tire|aftermarket-set|summer-tire|wheel-spec|tire-spec|ensure-compatibility|stock-summer|summer-tire|guy-shop|brief-searching|buy-aftermarket|aftermarket-wheel
post-photo|short-caption|1st-place|choice-2nd|2nd-place|good-luck|submit-contest|contest-entry
competition-look|size-sedan|fuel-efficiency|efficiency-price|price-point
previous-owner|owner-pay|boost-gauge|gauge-fluttering|base-boost|wastegate-actuator|actuator-need|need-adjustment|base-boost
like-old|old-truck|floor-shifter|floor-shifter|appreciate-thank
new-bike|bike-come|xxx-mile|xxx-mile|price-range|low-mile|wide-glide|mid-control|current-sportster|bit-short|new-bike
changer-keep|keep-try|change-cd|try-press|keep-kill|consider-change
loud-pop|suspension-component|small-rock|low-suspension|problem-solve
small-oil|oil-leak|trust-shop|uv-dye|oil-tank|small-leak|rear-main|main-seal|oil-level|oil-sealant|thank-guy
couple-month|new-exhaust|nice-happy|happy-sound
stall-start|start-fine|fine-cold|check-engine|engine-light|scanner-read|engine-die|fuel-pump|obd2-code|dashboard-light|light-warning|fuel-pump|pump-relay|fuel-pump
depth-buyer|buyer-guide|common-issue|test-drive|year-model|pleasure-driving|daily-driver
local-garage|low-control|control-arm|inner-tie|tie-rod|university-student|love-work|safe-simple
tax-title|nice-step|11mpg-new|new-tech|lot-easy|m-excited
year-round|round-car|snow-tire
little-accident|light-turn|turn-green|start-turn|turn-left|rear-driver|mechanic-look|wheel-balancing|constant-noise|speed-depend|tilted-hub|balancing-machine|intermittent-squeak|brake-pedal
k-lie|odd-reason|model-year|annoying-hump|odd-way|bit-lack|k-extra|extra-50hp|50hp-adjustable|adjustable-suspension|air-suspension
good-idea|bad-idea|visual-purpose|inch-tire|inch-tire|big-engine
long-story|story-short|regular-maintenance|38k-km|oil-change|trouble-start|engine-rev|oil-level|check-gas|gas-cap|cap-look
hypergreen-color|brand-new|car-paint|car-value
correct-sub|black-non|non-ab|invoice-price|reasonable-deal
brand-new|new-car|new-car|list-keep|keep-grow|good-place|loud-exhaust|famous-subie|subie-rumble|y'all-thought
timing-chain|chain-guide|guide-tensioner|near-future|good-price|new-stuff|stuff-labor|good-low|low-mileage|code-matching|matching-replacement|replacement-engine|timing-kit|mileage-block|new-timing|low-mileage|mileage-replacement|replacement-engine|new-engine
guy-think
unfriendly-people|solid-car|know-right|sport-car
cm-tall|inseam-floor|think-floor|steering-wheel|wheel-length|thereabout-people|people-drive|clutch-stop
try-replace|fuel-system|fuel-pump|fuel-pressure|pressure-sensor|plug-ignition|starter-relate|relate-fuse
blank-plate|fog-light|break-driver|state-inspection|fog-light|light-work|interior-coating|wiring-harness|new-harness|blank-plastic|plastic-plate|hole-leave|random-picture
old-post|sport-sedan|pricey-nav|mean-time|good-mount|mount-location|vent-mount|open-space
default-setting|adjust-setting|connect-easy|easy-fast|scroll-past
car-purchase|suuuuuper-excited|manual-transmission|test-drive|gx-gs|sticker-price|invoice-price|phone-play|good-deal|deal-cause|time-negotiate|guy-think|good-deal|average-deal
clutch-stuff|enumerate-list
external-mic
new-owner|s-alot|m-sure|change-body|body-panel
sighting-thread|r-teslamotor|vanity-post|vanity-post|birthday-cake|r-teslamotor|post-generate|actual-fruitful|fruitful-discussion|mod-rule|weekly-experience|experience-thread|new-post|r-teslamotor|r-teslamotor|great-place|good-interesting|interesting-discussion|discussion-disappear|lose-depth|r-teslamotor|content-look|model-add|car-clog|self-drive|birthday-cake|carpark-got|today-supercharger|taxi-discussion|battery-got|highlight-post|think-fall|vanity-post|lose-real|real-estate|good-discussion|low-reply|weekly-post|little-visibility|important-discussion
rabbit-hole|hole-solar|cordial-lining|drove-let|eye-contact|car-wait|near-available|available-charger|amazing-piece|car-connect|free-limit|wait-list|list-program|supercharger-location|message-pop|available-charger|start-charge|charger-space|real-issue|ice-spot|hope-people
vehicle-purchase|obligatory-picture|jeep-life|hid-headlight|fog-light|head-light|steering-wheel|stick-come|steering-wheel|flash-bright|fog-light|fog-light|indicator-light|strange-electronic|electronic-department|blinker-fail|forum-post|fuel-pressure|forum-post|remote-ignition|ignition-setup|setup-start|high-gear|center-console|great-effort|quarter-turn|turn-clockwise|good-effort|user-error|gear-grind|previous-owner|mean-floor|clutch-shift|clutch-floor|clutch-shift|preventative-maintenance|maintenance-replace|replace-fluid|fluid-etcetera|junkyard-door|previous-owner|instal-lock|door-hinge|new-door|door-unlock|worth-steal|rear-window|window-unzip|real-lock|good-course
throttle-body|cb-antenna|trailer-light|light-stop|stop-work|cb-antenna|work-trailer|trailer-light|improper-installation|cb-antenna|trailer-light|cb-antenna|big-road|road-trip|trailer-light|trailer-light|light-stop|stop-work|tail-light|mount-require|tail-light|light-assembly|convenience-disconnect|tail-light|light-assembly|critical-step|electrical-plug|tail-light|light-assembly|antenna-mount|mount-bolt|quarter-panel|panel-cut|sharp-edge|taillight-assembly|antenna-mount|taillight-assembly|plug-come|taillight-assembly|come-time|trailer-light|big-road|road-trip|hot-day|entire-family|big-error|trailer-light|taillight-assembly|trailer-light|stop-work|work-check|weekend-trip|minute-delay|delay-start
family-member|center-console|little-trouble|trouble-find|bluetooth-adapter|little-difficult|find-optional|year-old|old-car
fox-body|teenage-year|pantie-wet|beautiful-fox|fox-body|resale-lot|exact-fox|fox-body|number-match|motor-rebuild|forge-crank|beam-connect|connect-rod|multiple-clutch|clutch-cable|cable-clutch|clutch-pressure|pressure-plate|plate-motor|motor-mount|air-conditioning
unfortunate-run|piece-circle|try-look|recommend-place|complete-noob|quick-fix
good-deal|factory-warranty|include-detail|detail-lifetime|lifetime-drive|drive-train|paint-warranty
useful-information|problem-cause|random-moment|local-garage|error-code|code-u0009|additional-information|information-point|actual-cause|experience-symptom|sudden-engine|engine-stall|random-time|speed-gear|gear-outside|engine-temperature|clutch-usage|manual-transmission|random-time|spray-startpilot|brake-disk|disk-cleaner|air-filter|slow-traffic|warm-day|regain-power|huge-cloud|thick-black|black-smoke|smoke-come|fuel-line|fuel-line|fuel-injector|fuel-filter|filter-clean|fuel-filter|fuel-tank|glow-plug|plug-functioning|starting-problem|battery-healthy|low-voltage|cause-error|error-code|glow-plug|glow-plug|trouble-start|fuel-injector|car-start|local-garage|garage-find
low-ball|ball-joint|joint-replace|small-stuff|local-shop|big-job|job-time|time-belt|belt-axle|axle-seal|maintenance-record
rear-barrier|seat-cover|work-fit|hammock-style|style-rear|rear-seat|seat-cover
seat-bracket|motor-adjust|adjust-heating
active-sub|factory-sub|active-sub|think-standard|standard-speaker|speaker-wire|new-sub|amateur-question|aftermarket-stereo
day-thing|little-bit|build-plate|big-clump|filament-stick
good-care|250kish-mile|torque-converter|converter-issue|main-ride|fishing-hunt|hunt-vehicle|deer-hunting|hill-country|hunting-vehicle|standard-lift|lift-tire|stock-setup|gear-need|big-tire|rear-bumper|fun-vehicle|enjoy-ture|nice-keep
rear-brake|drill-slot|slot-rotor|individual-component|rear-brake|later-date|dangerous-situation|brake-balance
car-market|thing-clear|new-wheel|wheel-suspension|nice-exhaust|coupe-route|panda-esque|esque-scheme|white-paint|paint-job|black-wheel|wheel-honda|honda-logo|chick-magnet|second-look|finish-college|new-model|paddle-shifter|idea-suggestion
adapter-fine|music-shit|year-old|rear-passenger|tall-people|low-mileage|amazing-reliable|reliable-car|looking-time|official-app|read-page|copy-paste
transmission-good|sensing-system|sd-card|kid-like|folder-navigation|love-\(no|\(no-offense|wifi-connect|connect-hard|hard-drive|connected-thumb|thumb-drive|\-spee-transmission|bit-worried
pump-faulty|faulty-rod|rod-bearing|crack-subframe|mile-time|routine-maintenance|good-tune|tune-exhaust|exhaust-intake|body-mod|particular-budget|budget-restriction
second-car|old-car|drive-new|new-car|favorite-car|embarrassing-old|strange-noise|expect-headache|expensive-repair|young-professional|good-steady|steady-job
right-direction|power-inverter|work-truck|red-fault|fault-light|blue-normal|normal-light|red-fault|fault-light|little-annoying|12v-plug|plug-replace
little-background|card-change|select-eject|original-file|save-desktop|desktop-folder|sd-card|start-print|print-b|cancel-print|file-c|sd-card|select-print|print-c|select-e|format-card
auxiliary-fan|mishimoto-fan|fan-lie|wire-connector|wire-fan|ground-black|constant-power|small-yellow|yellow-red|red-wire|fan-speed|mixed-answer|edit-solve
couple-month|major-difference|early-year|good-year|extra-kick
gear-shift|heavy-acceleration|american-car|change-gear|damn-reason|c-class|fine-interior|dynamic-cruise|cruise-control|right-lane|car-sense|bother-slow|car-start|start-accelerate|change-lane|lane-assist|garbage-compare|single-exit|bit-surprised|auto-stop|stop-start|start-feature|save-fuel|stop-sign|red-light|single-time|wash-let|specific-question
rear-fender|easy-way|try-roll|buy-rear|rear-coilover|coilover-set|cheap-end
vehicle-start|second-thought|guy-think
couple-post|post-similar|specific-question|background-information|consider-purchase|early-reservation|wife-dog|dog-child|child-trip|current-car|nearby-lot|specific-question|autopilot-leave|test-drive|supercharger-station|preferred-route|salesperson-tell|free-supercharging|parking-service|charge-station|viable-option
couple-time|portable-evse|240v-charge|charge-station|240v-charger
online-researching|rental-car|extended-warranty|great-look|look-car|car-ride|ride-great|great-look|perfect-car|extended-warranty|bumper-coverage|add-mile
key-fob|car-button|button-push|week-old|secret-windshield|windshield-spot|door-release|trusty-service|service-center|zealous-cell|cell-tower|wireless-security|security-system|system-sensor|cellular-paging|~300mhz-spectrum|similar-problem|noticeable-antenna|antenna-array|fob-stop|stop-work|environmental-cause|service-center
common-compare|3rd-gen|3rd-gen|mental-nod|approval-lol
cylinder-gasoline|gasoline-engine|automatic-transmission|owner-car|feel-free
half-tempt|thing-look|look-sooo|sooo-nice|small-mod|glass-bed|glass-cut|local-hardware|hardware-store|store-cut|template-add|add-layer|add-small|small-binder|binder-clip|z-spacer|reliable-bed|bed-adhesion|dozen-fail|fail-print|component-pop
second-guessing|rev2.5-product|rev2.5-product|nut-buy
brand-new|black-rim|new-baby|decent-idea|stock-tire|total-cost|new-setup|stock-wheel
plastic-door|door-frame|frame-require|require-roof|roof-frame|frame-lock|lock-clip|clip-attach
lease-end|lease-end|test-drive|digital-interface|test-drive|glorify-prius
second-car|wife-steal|sweet-spot|compression-gremlin|little-engine
decent-truck|highway-mile|truck-look|look-clean|valve-cover|cover-leak|leak-oil|valve-cover|water-pump|time-belt|ski-resort|need-new|new-tire|terrain-tire|tire-handle|brand-new|winter-assume
good-morning|time-poster|low-mileage|non-audi|audi-dealership|fair-price|carbon-build|carbon-build|common-issue|carbon-build|relate-issue|opinion-appreciate
long-story|story-short|second-car|similar-experience
non-turbo|basic-mod|buy-speed|different-platform|helpful-thank
15k-sport|sport-car|daily-driver|reliable-fun|fun-daily|daily-driver|mr2-spyder|performance-difference
wind-rain|rain-deflector|dealer-today|pair-fit|rear-require|piece-bulge|feel-wrong|wrong-bend|look-right|cross-year|year-compatibility
low-tire|tire-pressure|pressure-light|light-come|gas-station|door-jamb|light-come|sensor-need
big-rim|unique-taste|understand-people|feel-shitty
second-v1|chess-set|queen-print|print-fine|sit-open|bed-surface|bed-leveling|leveling-issue|little-glob|extruded-layer|let-print|print-run|jammed-filament|filament-melt|clog-nozzle|clogged-nozzle|brand-new|new-roll|filament-produce
post-facelift|facelift-manual
input-suggestion|work-truck|travel-trailer|camping-spot|backup-camera|perfect-scenario
test-drive|drive-check|seller-run|auto-repair|repair-place|prev-owner|owner-upgrade|new-car|clean-check|check-vin|accident-report|month-thing|check-rust|head-number|number-hydraulic|hydraulic-rear|rear-suspension
bit-dissatisfied|stock-shifter|gold-standard|standard-solution|upgrade-different|good-performance|stock-shifter|warranty-implication|improve-stock|assembly-attachment|stop-gap|half-measure|performance-improvement|shifter-base|base-bushing|bushing-purchase|purchase-obsolete|great-experience|budget-friendly|friendly-modification|bracket-bushing|bushing-upgrade|attach-stock|stock-shifter|shifter-assembly|guy-link|weird-middle|middle-ground|stock-shifter|tran-mount|mount-solid|solid-feeling|tran-attach|option-performance|performance-improvement|cheap-option|option-bad|bad-bang|diminish-return|return-territory|money-spend|regret-jump|appreciate-thank
long-commute|different-car|easy-fix|fix-thx
look-recommendation|fog-light|light-bezel|correspond-harness|c-light|light-drl|crack-open
new-car|low-mile
112k-mile|mile-stock|new-slotted)rotor|past-60k|60k-mile|growling-noise|noise-feel|steering-wheel|popping-noise|highway-speed|passenger-wheel|wheel-sound|rough-pavement|slight-bump|10k-mile|mile-leave|leave-brake|fine-alignment|multiple-time|rear-wheel|wheel-bearing|10k-mile|little-concern|high-way|colder-weather|weather-come|far-point|cv-joint|wheel-bearing|tie-rod|look-people|makeshift-tool|change-ball|ball-bearing|bearing-reduce|inspect-cv|cv-find|keep-look
stagger-wheel|winter-tire|cost-effective|effective-option
new-mb|mb-a180d|bussiness-pack|option-add|describe-android|android-auto|play-music|car-sorry|newbie-question
error-code|transmission-fluid
pair-phone|phone-list|infotainment-owner|sound-correct
trash-bin|bin-junk|search-look|thing-hold|total-wreck|nice-ratio|single-previous|previous-owner|good-shape|crazy-low|low-mile|weathertech-floor|floor-mat|original-asking|asking-price|extra-vehicle|alignment-wheel|wheel-balance|radio-steering|steering-wheel|wheel-button|delaminate-replace|replace-radio|stupid-air|air-suspension
start-drive|abs-fuse|abs-module|speedometer-problem|problem-begin
second-ms|sale-agent|agent-try|perfect-fit|fit-ready|old-car|car-right
club-style|style-bobber|cam-valve|spring-carb|carb-exhaust|solo-seat|crazy-expensive|t-bar|t-bar|iron-head
sport-package|package-manual|manual-mile|ask-11k|worthy-buy
new-home|outlet-instal|charger-instal|good-type|standard-outlet|total-cost
odb2-code|different-fix|gas-pedal|throttle-body|natter-tray|definite-answer
wife-comfortable|stop-short|short-guy|guy-problem|sd-seat|d-world
car-today|faint-de|ignition-brake|brake-lock|strange-whir|whir-noise|noise-come|dome-light|loud-version|forum-search
gather-information|tow-hitch|trunk-space|spare-tire|tire-compartment|u-haul|haul-sell
conflict-information|play-video|specific-format|play-audio|support-video|video-format|maximum-25fps|high-trim|trim-level|specific-package|video-playback|video-playback|asterisk-indicate|certain-trim|trim-package|convenience-package|package-instal|reprogram-hack|hack-enable|enable-video|legit-way|play-video
print-warp|warp-issue|issue-today|buy-glass|glass-cut|mm-spacer|rub-alcohol|glue-stick|warping-post|try-safety|safety-razor|razor-blade|blade-spatula|try-spritz|rub-alcohol|print-try|magic-trick
video-_url_|try-toggle|air-recycle
long-time|terrible-driver|car-survive|survive-multiple|multiple-year|test-drive|car-drive|fun-car|car-available|sale-guy|guy-tell|metallic-grey|25k-mile|test-drive|tad-bit|bit-slow|look-outdated|look-modern|good-condition|day-drive|informed-decision|emotional-buy|low-mileage|mileage-oil|oil-change|hit-18k|18k-mile|huge-issue|red-flag|oil-change|common-thing|original-warranty|car-expire|buy-extended|extended-coverage|sale-guy|guy-tell|extended-coverage|cover-brake|brake-pad|extend-warranty|brake-pad|purchase-extended|extended-warranty|original-warranty|warranty-end|warranty-end|final-question|good-price|33k-today|list-option|basic-spec|lease-return|exterior-color|red-highlight|highlight-stitching|co2-relevant|relevant-vehicle|door-opener|mat-auto|auto-dim|dim-mirror|mirror-auto|auto-dim|dim-rearview|rearview-mirror|mirror-power|rear-seat|seat-storage|storage-package|package-heated|trim-finisher|finisher-pearl|pearl-blow|distance-control|control-rain|rain-sensor|auto-headlight|headlight-adaptive|adaptive-light|light-control|control-automatic|automatic-climate|climate-control|control-ambient|ambient-lighting|lighting-additional|-v-power|power-socket|surround-sound|sound-dvd|dvd-area|area-code|speed-limiter|limiter-variable|variable-light|light-decode|drive-light
preheat-mode|temperature-reading|target-temperature|late-firmware|display-change
great-deal|deal-close|grille-design|major-thorn|nigh-unusable|midrange-android|android-device|device-moto|moto-phone|caller-report|choppy-spurt|head-unit|unit-function
crazy-idea|inch-spacer|spacer-lift|cyl-automatic|tube-fender|gearing-braking|cheap-plan|brake-upgrade|lcog-rig|sand-dune|minor-rock|rock-crawl
carry-aftermarket|recent-year
car-rough|rough-idle|turbo-surging|weak-acceleration|dirty-throttle|local-mechanic|coil-ignition|error-code|code-come|throttle-body|good-cleaning|cleaning-look|slight-snag|broken-end|old-hose|don;t-know|throttle-body|simple-fix
cls-lease|past-week|current-402hp|daily-driving|hear-mixed|mixed-opinion|look-amazing
powerwall-installation|backup-power
red-light|car-kind|continue-rolling|parking-brake|brake-light|light-come|complete-idiot|honest-accident
dome-light|switch-break|stage-switch|dealership-want|google-search|find-replacement|entire-unit
performance-air|air-intake|keep-add|add-piece|extra-pep|dyno-schedule|improve-performance|edit-forgot
gear-speed|main-concern|wheel-come|regular-thing|dirt-bike
replacement-block|good-condition|different-imprint|original-block|easy-way
brake-pedal|bleed-valve
anonymous-neighbor
stock-clutch|period-thing|sound-clunky|engagement-point|gt-clutch|drive-manual|user-error|low-gear|steeda-assist|assist-spring|big-difference|similar-experience
constant-snow|rainy-climate|climate-keep|stay-cold|multiple-thing|stay-unmoved|cause-mold|seat-wet|rainy-climate|rampage-frameless
definitive-answer|track-rex|cobb-stage|accessport-tune|track-drive|real-power|power-mod|reccomend-spring|spring-strut|ride-quality
roll-cage|good-search|search-term|stock-fiberglass|fiberglass-shell
tail-light|tail-light|drag-specialty|custom-dynamic|little-happy|guy-run|stupid-bright|bright-ambulance|ambulance-tail|tail-light
new-vehicle|favorite-option|hard-time|time-hone|issue-buy|sound-amazing|extra-cost|unique-interior|surround-system|premium-cost|bloat-price|base-gt|keep-cost|daily-driver|big-congested|congested-town|close-family|family-member|member-suggest|suggest-automatic|manual-truck|bad-traffic|avoid-traffic|stripe-cheezy|offcentered-stripe|white-white|white-platinum|platinum-car|convertable-?|convertable-manual
print-large|large-thing|print-today|bed-warm|warm-running|bed-set|glue-stick|print-flat|start-curl
model-year|beautiful-sport|sport-steering|steering-wheel|nice-seat|nice-exhaust|extra-horsepower|nice-steering|steering-wheel|pay-15k|pretty-steering|steering-wheel|steering-wheel
consider-buy|differential-open|sport-differential
engine-mode|high-pitch|pitch-whine
calibration-cube|good-print|printer-lay|2nd-layer|second-question|similar-material
ball-joint|eventual-replacement|poor-rating|expect-reliability|heart-set
spare-tire
trouble-decide|mile-white|white-a4|mile-black|trouble-decide|follow-reason|white-color|wood-interior|low-milage|long-life|life-span|little-iffy|time-correct|low-milage
overall-rebuild|rebuild-mod|rear-wheel|wheel-wheel|wheel-cut|new-section|section-weld|transmission-explode|case-break|shifter-linkage|lack-5th|long-trip|thorough-craigslist|craigslist-hunt|owner-dealer|dealer-maintain|little-waggling|fair-price|fair-share|near-perfect|lip-rear|rear-spoiler|roof-rack|hour-detail|clay-bar|bar-wax|interior-engine|nice-weekend
allen-head|head-bolt|exhaust-stud|actual-exhaust|exhaust-stud|bolt-break|obvious-answer|nut-weld|work-welding|welding-place|insane-price|distant-mechanic|red-loctite|insane-welder
stock-tweeter|stock-location|illusion-audio|audio-fit|stock-corner|corner-dash|dash-location|find-diagram|speaker-diameter|diameter-mount|mount-depth|depth-require
nice-daily|daily-driver|328i-wagon|bit-weary|ol-reliable|key-option|cargo-space|carry-gym|gym-equipment|waste-money
new-truck|truck-shell|sweet-door|small-hatch|hatch-style|style-door|door-embed|original-door|original-hinge|previous-owner|literal-interior|interior-door|door-hinge|original-inset|factory-hinge|hinge-remain|right-hinge|horrify-reflection|yeti-like|like-arm|arm-cheer
extrusion-issue|spongy-print|little-extrusion|extrusion-knock|error-cause|solid-smooth|smooth-surface|bad-print|print-head|poor-insulation|hot-end|high-temp|temp-insulation
aftermarket-head|head-unit|bus-gateway|battery-drain|aftermarket-unit|original-unit|hack-firmware|original-unit|new-unit
day-round|round-trip|gas-milage|milage-come
little-thing|thing-annoy|wiper-leave|huge-untouched|untouched-spot|middle-seat|rear-vent|great-car|time-tonight|quick-peak
325xi-accident|accident-free|old-style|car-look|trust-mechanic|automatic-transmission|thank-guy
set-screw
power-indicator|dash-maxe|gas-engine|artificial-limitation|limitation-impose|engine-control|nice-round|round-number|hybrid-mode
owner-southern|southern-vehicle|taxis-title|unrealistic-expectation|current-market|4th-gen|dealer-counter|counter-offer|couple-day|help-guy
fly-rock|rock-chip|chip-paint|driver-door|chip-paint|hood-area
manual-tran|carbon-cleaning|fuel-pump|pump-cat|new-version|turbo-bypass|bypass-valve|valve-coil|coil-pack|pack-low|low-temp|temp-spark|spark-plug|plug-drill|drill-slot|slot-rotor|look-cool|high-flow|flow-cat|timing-belt|belt-clutch|clutch-chain|rattle-new|new-motor|motor-mount|mount-change|diff-fluid|fluid-oil|oil-change|basic-maintenance|maintenance-item|thing-instal|close-dealer|cost-wise|drive-able|able-tune|little-conservative|helpful-unitronic|aggressive-tune|look-fun
mud-bogging|stock-wheel|p245/70r16-tire|factory-fender|fender-flare
recommend-tire|tire-brake|brake-fluid|occasional-track|track-day|short-time|recent-purchase|think-excellent|excellent-sight|sight-line|underrated-quality|fast-car|technical-standpoint
map-acceleration|acceleration-performance|battery-charge|charge-level|performance-impact|battery-charge|charge-decline|battery-size|old-model
mini-model|there(full-credit|good-detail|stray-strand|temp-setting
start-look|boxster-cayman|certify-pre|boxster-s|upgrade-sport|25k-mile|20k-mile|certify-porsche|certify-porsche|porsche-dealership
branch-fall|couple-hour|chrome-trim|paint-chipping|actual-dent|pressure-device|body-shop|body-shop
run-flat|dealer-recommend|recommend-new|new-tire|non-run|run-flat|comfort-reason|road-travel
gas-tank|tank-shut|charcoal-canister|canister-area|help-provide
great-shape|consistent-reading|transmission-dipstick|service-manual|manual-instruction|instruction-park|level-surface|engine-idle|parking-brake|brake-apply|apply-shift|p-position|clean-rag|fluid-level|hot-range|normal-driving|driving-temperature|dipstick-appear|cold-range|add-fluid|proper-level|dipstick-rest
right-direction|little-plastic|plastic-catch|center-console|console-arm|arm-rest|arm-rest|new-center|center-console|mind-find
exact-version|dealer-certify|certify-pre|auto-tweak|nav-simcard
stock-mini|mini-ape|female-harness|harness-plug
post-mortem|close-inspection|heat-block|block-wire|temperature-sensor|sensor-wire|white-plastic|thing-temperature|temperature-sensor|slave-heat|heat-bed|bed-power|power-supply|protect-power|power-strip
fatboy-low|cleaner-exhaust|big-radius|good-performance|performance-compatibility|performance-calculator
road-trip|fantastic-supercharge|painless-experience|highlight-autopilot|autopilot-work|wind-road|way-road|speed-limit|town-autopilot|maximum-speed|increase-safety|reduce-driver|driver-fatigue|supercharger-stall|public-charging|lane-road|short-straight|straight-stretch|engine-noise|hour-drive|control-music|huge-display|lane-change|keep-blink|sort-indicate|indicate-failure|lane-change|ice-car|long-road|road-trip|ice-free
print-start|home-axis|nozzle-touch|thing-a.|a.-attempt|expose-metal|home-axis|provide-hex|hex-tool|print-bed|issue-remain|faulty-gcode|issue-turn|printer-try|try-multiple|multiple-different|different-print|print-attempt|attempt-print|clean-nozzle|filament-return|return-printer|factory-setting|gcode-ensure|mechanic-component|proper-place|issue-appear|small-thing|noob-mistake|borosilicate-glass|glass-bed|glass-bed|borosilicate-glass
girlfriend-house|battery-light|light-turn|minute-start|thing-happen|keep-happen|couple-minute|check-engine|engine-light
title-suggest|fuel-problem|car-shut|investigate-oil|oil-temperature|fuel-pump|sluggish-start|ideal-state|drive-home|diagnostic-reading|screen-read|fuel-pressure|pressure-problem|fuel-filter|filter-fuel|fuel-pump|bit-easy
year-old|old-window|window-weatherstripping|old-vehicle|allow-easy|easy-access|modern-replacement|window-weatherstripping|old-vehicle
huge-storm|car-turn|big-truck|truck-splatter|splatter-ton|try-turn|nasty-noise|foot-brake|sun-try|insurance-come|try-start|car-start|gas-smell|smell-smoke
blink-red|circuit-breaker
little-extra|extra-step|cheap-plastic|plastic-stool|perfect-excuse|rock-rail
5th-gen|gen-4runner|holy-shit|love-4runner|consider-sell|5th-gen|find-solid|solid-year
drive-mediocre|mediocre-car|decent-motor|pure-traction|drivability-department|post-pic|sexy-smoke|smoke-tail|tail-light|guy-n|n-gal
mechanic-blind|heavy-hammering|car-start|process-start
employee-discount|sport-package|receive-decent|decent-snowfall|perfect-world|pay-sub|sub-40k|edit-thank|help-r|dealer-yesterday
popular-package|package-today|configure-car|car-setting|realize-maintenance|guy-set|schedule-maintenance|maintenance-oil|oil-change|tire-rotation|power-outlet|arm-rest
service-oil|oil-change|change-break|courtesy-vehicle|late-model|model-ruby|ruby-red|bad-right|sport-sedan|razor-sharp|sharp-handling|handling-intimate|intimate-road|road-feel|perfect-balance|tight-leather|leather-glove|thick-wool|wool-mitten|olympic-speedskater|unmistakable-flat|growl-replace|burble-unique|throttle-response|linear-power|power-available|little-happen|turbo-spool|foreground-begin|momentary-pass|pass-opportunity|nice-car|nav-system|system-backup|backup-camera|creature-comfort|sport-sedan|sensation-describe
low-mileage|controversial-car|find-mechanic|regional-thing|smart-purchase|maintenance-need|time-car|car-buyer
astronomical-high|high-tide|tide-associate|winter-storm|wrangler-unlimited|claim-adjuster|saltwater-flood|flood-car|total-loss|sentimental-value|sentimental-value
c-light|compressor-turn|radiator-look|look-normal|blow-warm|warm-air|stop-work|wrong-fuse|correct-fuse
early-version|model-year|model-year
pristine-look|brand-new|new-tire|tire-summer|bell-whistle|private-dealer|low-18k|18k-mile|good-condition|guy-want|guy-think|maintenance-cost
daytime-running|running-light|light-appear|indicator-mean
oil-filter|filter-housing|housing-leak|initial-repair
chevy-cobalt|clown-car|f150-fx4|need-advice
digital-gauge|gauge-reflect|fuel-light|light-flash|future-referance|gas-cap|leak-fuel|fuel-senser|senser-float|fuel-system|need-replace|help-edit|error-code|maintenance-letter|problem-persist
want-keyless|keyless-entry|remote-start|start-option|brake-light|brake-switch|stop-fuse|shift-lever|relay-click|good-place|viper-system|starter-wire
community-think|gts-package|ventilate-seat|centerlock-wheel|wheel-yay|nose-lift|lift-yay|metal-sunroof|come-standard|long-wait
tribeca-need|extended-warranty|maintenance-loom|local-dealer|dealer-want|guy-think|great-deal
milk-crate|crate-hold|original-engine|good-bit|miscellaneous-stuff|main-concern|surface-rust|end-rebuild
fresh-lurker|prius-plug|price-point|low-mile|lane-departure|departure-warning|collision-warning|hour-drive|accident-report|quieter-ride|low-ev|ev-range|hint-thought|thought-insight|small-difference
radio-model|thank-guy
bluetooth-audio|know-problem
mirror-adjustment|adjustment-switch|stop-work
online-auction|auction-site|turbo-charge|good-advice
appearance-mod
instrument-cluster|cluster-light|turn-signal|signal-light|light-flash|start-rip|rip-stuff
consider-pick|prefer-purchase|rust-belt|hear-story|pre-purchase|purchase-question|helpful-assumption|4th-gen
huge-leak|know-issue|brake-light|light-foam|foam-gasket|gasket-degrade|time-allow|internal-leak|gasket-unlimited|unlimited-info|sneaky-leak|leak-check|cargo-hold|tailgate-carpet|tiny-plastic
4wd-limited|drive-blink|blink-start|reputable-garage|car-run|new-electric|electric-motor
people-mention|hilly-area|kinetic-energy|logic-dictate|share-drivetrain|drivetrain-loss|regen-conversion|conversion-loss|contest-issue
print-speed|new-firmware|stepper-motor|dungeon-tile|print-time
fuel-efficiency|efficiency-improve|improve-electric|electric-range|improved-interior|perfect-vehicle|electric-car|car-segment|overall-range|range-stylish|stylish-exterior|strike-exterior|electric-vehicle|board-generator|dread-range|range-anxiety|previous-model|require-driver
installation-tutorial|installation-come|maintenance-\(such|time-change
low-mileage|mileage-sub|sub-70k|final-year|import-thesis|thesis-beast|good-car|error-prone|prone-mechanic|mechanic-bait|second-friendly|friendly-german|dog-ski
big-question|fresh-fuel|dryer-sheet|keep-mouse|mind-leave|oil-change|couple-week
square-tubing|receiver-hitch|winch-plate|big-problem
mini-ape|drag-bar|need-new|new-cable|try-search|definitive-answer|time-thank
lame-o|tire-shred|feel-compel|badge-brother|couple-kid|hyper-aware|collision-awareness|note-thank|cheap-emergency|emergency-jack
longitudinal-acceleration|acceleration-sensor|sensor-throw|gotthard-tunnel|half-way|traction-control|control-light|light-come|vag-com|longitudinal-acceleration|acceleration-sensor|sensor-code|tunnel-happen
grand-plan|comfortable-bike|long-haul|cooler-bar|bar-hopper|hopper-custom|custom-bike|basic-maintenance|idea-tip|mini-road|road-king|upgrade-black|black-bag|bag-white|white-fender|fender-windshield|windshield-cruiser|cruiser-bar|large-tank|cool-decal|tank-pig|cop-uniform|uniform-bacon|bacon-strip|vintage-font|dirty-bobber|bobber-throw|sissy-bar|bar-springer|engine-rebuild|rear-fender|fender-matte|matte-black|ape-faux|faux-ironhead|ironhead-tear|tear-drop|drop-intake|intake-ape|ape-bobbed|bobbed-fender|fender-bare|bare-bone|s-good|s-worth|end-rebuild|rebuild-come|good-time|local-dealership|unlimited-budget
final-decision|wise-word|daily-driver|follow-choice|year-old|-20k-mile|cheap-option|year-old|-30k-mile|expensive-option|year-old|-30k-mile|middle-price|mention-concern|decision-factor|important-concern|concern-headroom|difficult-time|time-squeeze|local-dealership|head-touch|seat-leave|bit-disappointed|litre-turbodiesel|base-model|automatic-transmission|drive-manual|automatic-car|cheap-rental|rental-car|old-automatic|automatic-system|appropriate-gear|gear-base|drive-style|bit-annoying|daily-driver|automatic-manual|manual-decision|important-decision|decision-factor|priority-order|long-time|unforeseen-circumstance|maintenance-cost|money-time|fuel-consumption
young-woman
load-msrp|black-interior|year-lease|year-leave|like-red|year-lease|good-deal|manager-come|good-deal|mistake-needless|brand-new|current-payment|year-lease|special-feel|smooth-car|keep-want|upgrade-car|drop-80k
cool-look|v70r-tailgate|tailgate-spoiler|exact-color|generation-wagon
weird-idling|cold-start|little-bit|bit-low|temperature-gauge|drop-idle|car-vibrate|normal-operating|operating-temperature|guy-know|start-look|little-bit
bit-sporty|exterior-look|bit-boring|current-look|door-aspect|rear-suspension|rise-compare
3d-printing|mail-today|try-heat|push-filament|little-drop|white-filament|filament-ooze|guitar-string|hot-end|little-metal|metal-tube|tube-reach|hot-end|low-grub|grub-screw|try-pull|original-blockage|fitting-hex|hex-key|3d-printing|printing-experience|start-explore|3d-printing|thing-come|extruder-break|replacement-lever|awsome-machine
minor-issue|warranty-exp|couple-week|wind-noise|noise-come|left-shoulder|rear-driver|rubber-seal|customer-info|mention-minor|minor-wind|wind-noise|insignificant-seepage|window-alignment
week-vacation|vacation-leave|car-outdoor|unknown-time|12v-battery|battery-crap|emergency-key|tow-truck|car-run|loud-noise|cold-snap|multiple-day|dealer-replace|battery-pack
red-brake|brake-light|brake-light|fog-light
lift-kit|terrible-luck|fuel-pump|pump-die|work-yesterday|rental-car|suspension-asap|f*cke-terrible|avoid-offroade|headache-lol|lift-kit|good-replacement|replacement-stock|stock-suspension
v40-sport|sport-estate|head-unit|new-unit|hand-free|model-headunit|straight-swap
3d-printer|sd-card|card-figure|test-model|print-perfect|auto-create|great-profile|profile-starting|starting-point|exist-gcode|gcode-file|produce-print|like-know|solid-starting|starting-point|rumor-magic|magic-number
market-value
long-time|project-car
select-mini|cat-file|current-version|current-version|print-thing|brand-new|thank-community
trip-screen|visit-family|+-mile|mile-trip|love-long|long-drive|usual-refueling|refueling-spot|cruise-control|control-set|cruise-speed|hold-mode|ice-engine|good-mileage|planned-refueling|refueling-stint|cruise-speed|voltec-design|design-allow|cycle-engine|efficient-range|lb-car|couple-thing|engine-recharge|little-bit|1000mi-trip|use-mountain|mountain-mode|maintain-acceleration|sacrifice-gas|gas-mileage|charge-hit|limp-mode|big-deal|hour-trip|fuel-door|bug-deflector|dead-bug|bug-splat|keep-bug|highway-speed|magnetic-damper|ride-quality|road-trip|cabin-noise|noise-level|adjustment-option|system-use|practice-run|temperature-drop|perfect-car|short-trip|diesel-locomotive|great-configuration|long-trip|fuel-tank|voltec-drivetrain|fun-luxurious|luxurious-body|hidden-gem
great-shape|minor-problem|aesthetic-mod|black-headlight|rear-black|black-sequential|sequential-rear|rear-light|sinistre-look|guy-think
daughter-throw|half-hour|hour-drive|small-fortune
failure-warn|warn-long|long-story|enjoy-drive|performance-luxury|luxury-type|type-car|regular-traffic|super-grabby|happy-medium|regret-buy|fast-car
small-community|community-airport|large-annual|annual-event|destination-charger|charger-program|single-response
clublexus-thread|people-mention|print-text
early-model|typical-early|early-adopter|adopter-problem|new-polish|initial-build|wheel-drive|cold-weather|weather-package|near-term
different-standard|standard-color|additional-add|mobile-start|dealer-online|body-know|price-point|year-old|old-car
good-morning|prong-plug|zip-tie|lose-block|block-heater|couple-thing|special-oil|oil-recommendation|routine-maintenence|maintenence-require
ceramic-break|notice-sporadic|sporadic-squeaking|squeaking-come|squeaky-ceramic|ceramic-brake|brake-fluid|fluid-flush|major-maintenance|possible-new|new-brake|brake-fluid|fluid-reduce
size-truck|extra-bed|bed-space|little-background|access-quad|quad-cab|door-truck|reliability-long|long-term|term-drive|drive-quality|test-drive|follow-list|particular-order|different-truck|double-cab|ride-quality|steep-hill|k-cheap|k-cheap
couple-week|thank-goodness|engine-light|simple-electrical|s-easy|old-dealer|valve-break|crank-seize|spark-plug|bike-carnage
speaker-size|premium-package|speaker-size
open-box|power-supply|look-brand|brand-new|axis-control|different-surge|surge-protecter|wall-outlet|home-axis|bad-power|power-supply|firmware-issue|power-supply|power-brick|second-time|wrong-version|version-printer
work-print|heater-wire|wire-reroute|heated-bed|long-hole|thermal-insulation|know-revision|people-advise|advise-new|new-owner|bed-reroute
check-engine|engine-light|vapor-cannister|cheap-reason
remember-hear|hear-year|automatic-transmission|drivetrain-loss|manual-transmission|new-automatic|dual-clutch
yesterday-evening|clutch-click|bite-point|pedal-sound|sound-similar|common-issue|good-wait|post-break|period-oil|oil-change|service-dept|recent-owner|owner-experience
short-trip|wheel-break|break-free|nice-little|little-squeal|squeal-continued|sport-mode
blob-eye|eye-wagon|current-hang|need-new|new-rim|rim-tire|need-new|new-tire|size-wheel|wheel-people|size-tire
good-shape
sound-come|motor-sound|sound-spin|smog-pump|instal-smog|smog-pump|emission-level|pump-clean|clean-air|good-idea|repair-replace|smog-pump|stupid-expensive|real-problem|work-leave|work-overtime|smog-pump|pass-emission|emission-test|emission-total|ramble-post|obligatory-picture
seek-opinion|style-rack|custom-fabricate|basket-style|style-rack|utility-rack|ideal-long|long-item|carry-paddle|kayak-surfboard|cargo-style|small-item|long-item|hybrid-design|basket-style|gobi-stealth|long-item|strong-way|removable-crossbar|scaffold-style
stock-transmission|dealer-shop
new-trunk|trunk-come|emergency-trunk|trunk-release|latch-mechanism|old-trunk
wish-list|new-car|simple-solid|solid-gas|gas-mileage|work-leather|leather-seat|seat-android|android-auto|smooth-drive|great-cost|cost-efficient|efficient-option|main-difference|turbo-charge|charge-engine|quick-pickup|work-route|great-price|offer-trade|expect-similar|similar-result|edit-sorry|ugly-uncapitalized|uncapitalized-title|reason-lol
dealership-mechanic|run-idol|degree-day|winter-evening|clicking-sound|experienced-guy
base-package|down-payment
ironhead-project|basket-case|start-mess|good-resource|battery-ignition|ignition-alternator|alternator-generator
year-love|electric-mode|slow-speed|musical-sound|sound-come|red-light|light-people|window-open|window-open|sound-computerized|computerized-music|electric-mode|help-explain
long-story|story-short|disclose-history|civic-hybrid|civic-hybrid|bad-battery|bit-sluggish
limited-service|normal-connect|usual-message|radio-turn
look-space|rattle-sound|sound-come|bit-concerned|test-drive
brand-new|key-fob|fob-trunk|trunk-release|release-button|hand-release|actual-key|pdi-process|display-vehicle|upcoming-event
test-drive|modification-adventure
low-cost|trouble-find|guru-know|reasonable-asking|asking-price|decent-condition|small-chip|oil-screen|screen-5k|5k-mile|oil-sludge|sludge-problem|small-vacuum|vacuum-leak|leak-cause|idle-rough|run-fine
proper-summer|summer-tire|experienced-driver|hailcorprate-shoutout
trailer-hitch|bike-rack|weigh-cost|install-hitch|rack-rail|current-owner|trunk-rack
autonomous-drive|drive-feature|driver-attention|help-ease|long-commute
rear-left|left-blinker|left-blinker|rear-light|extra-fast|fast-flasher|turn-signal|left-blinker|function-fine|turn-signal|signal-work|research-trouble|trouble-shoot|shoot-tip|indicator-switch|switch-relay|left-rear|rear-light|light-assembly|try-change
paperwork-establish|foreign-market|thing-tell
little-closable|closable-pocket|fine-gentleman|effective-use
select-mini|3d-printer|basic-print|camera-mount|mount-case|important-item

535i-oil|oil-level|level-sensor
dumb-mistake|radio-panel
loud-mouse|mouse-squeaking|try-lift|try-spray|surround-area|about10-minute|try-lube
adapter-seal|oil-cooler|cooler-gasket|enjoyable-pain|oil-pressure|pressure-light|air-bubble|oil-pump|extra-info|oil-change|oil-system|slow-leak
fucking-help|help-desk|color-format|turn-night|night-mode|op-post|huge-deal|issue-edit|edit-res|res-=
maintenance-schedule|water-pump|timing-build
